Business_ID,Annual_Revenue,Requested_Loan_Amount,GST_Compliance,Past_Defaults,Bank_Transactions,Market_Trend,Credit_Score,Sanctioned_Loan_Amount,Difference
1000,2950164,573998,95,0,Unstable,Growth,568,573998,0
1001,1775138,171050,99,1,High Volume,Growth,659,171050,0
1002,3328895,274013,93,0,Low Volume,Stable,540,274013,0
1003,6705401,619741,87,0,High Volume,Growth,657,619741,0
1004,1644057,513425,88,0,Stable,Declining,529,328811,184614
1005,1644078,120425,92,0,Stable,Stable,594,120425,0
1006,7013660,1414074,94,0,Stable,Declining,546,1402732,11342
1007,3663567,1424907,84,1,Stable,Stable,501,732713,692194
1008,1361940,248495,94,0,High Volume,Declining,575,248495,0
1009,3060375,1204223,94,0,Unstable,Declining,476,612075,592148
1010,1368555,527523,89,0,Stable,Growth,615,410566,116957
1011,1366026,219414,92,0,High Volume,Stable,626,219414,0
1012,2406225,909481,92,0,High Volume,Declining,596,481245,428236
1013,500000,193250,88,0,High Volume,Stable,623,150000,43250
1014,500000,114427,87,0,Stable,Growth,629,114427,0
1015,1264478,182956,89,0,Low Volume,Stable,528,182956,0
1016,881813,250939,87,0,Unstable,Declining,470,176362,74577
1017,2549475,1184560,92,0,Low Volume,Stable,535,509895,674665
1018,958937,323955,91,0,Stable,Stable,565,191787,132168
1019,640598,81878,92,0,Stable,Growth,608,81878,0
1020,6404549,2287965,89,0,Stable,Stable,581,1280909,1007056
1021,1655112,400937,77,1,Stable,Growth,554,331022,69915
1022,2092819,661724,88,0,Low Volume,Declining,464,418563,243161
1023,634252,241224,79,0,High Volume,Declining,519,126850,114374
1024,1282721,361376,92,0,Stable,Declining,531,256544,104832
1025,2166748,902002,94,0,Unstable,Growth,581,433349,468653
1026,789539,296053,92,0,Stable,Stable,559,157907,138146
1027,2677940,875105,91,0,Stable,Stable,589,535588,339517
1028,1226272,144524,92,0,Low Volume,Stable,533,144524,0
1029,1570092,669137,95,0,Low Volume,Growth,623,471027,198110
1030,1225225,577274,85,0,Stable,Declining,521,245045,332229
1031,8726043,974126,89,2,Stable,Declining,447,974126,0
1032,1961465,529024,97,1,High Volume,Stable,610,529024,0
1033,850714,141644,94,0,High Volume,Stable,637,141644,0
1034,3828700,1491415,93,0,Unstable,Stable,514,765740,725675
1035,746630,279787,93,1,Low Volume,Stable,510,149326,130461
1036,2343347,265732,84,0,Unstable,Stable,503,265732,0
1037,500000,222331,95,0,Low Volume,Declining,497,100000,122331
1038,685190,90060,88,1,Stable,Declining,478,90060,0
1039,2320954,948728,93,1,Low Volume,Declining,452,464190,484538
1040,3579642,915104,89,0,Low Volume,Growth,567,715928,199176
1041,2274099,449641,98,0,High Volume,Stable,640,449641,0
1042,1807547,219089,84,0,Stable,Stable,571,219089,0
1043,1558317,195454,89,0,Stable,Growth,612,195454,0
1044,607546,211335,96,0,High Volume,Growth,688,182263,29072
1045,1114732,331849,91,1,High Volume,Declining,551,222946,108903
1046,1371601,143934,91,0,Stable,Growth,629,143934,0
1047,4619042,465202,95,0,Stable,Growth,621,465202,0
1048,2610088,215436,90,0,High Volume,Declining,577,215436,0
1049,500000,192348,89,0,Low Volume,Growth,597,100000,92348
1050,2569616,951649,89,2,Low Volume,Declining,421,513923,437726
1051,1457064,111165,86,0,High Volume,Growth,670,111165,0
1052,1153674,348550,96,0,Unstable,Growth,586,230734,117816
1053,3234358,284961,96,0,Low Volume,Stable,576,284961,0
1054,4523514,2065824,92,1,Low Volume,Stable,509,904702,1161122
1055,4176667,1913761,88,1,High Volume,Declining,539,835333,1078428
1056,1013202,369013,97,0,Unstable,Growth,577,202640,166373
1057,1548241,722696,93,0,Unstable,Stable,504,309648,413048
1058,2584418,1072931,97,0,Stable,Declining,553,516883,556048
1059,4327221,1829732,90,2,Unstable,Stable,435,865444,964288
1060,1351412,414030,93,0,Stable,Declining,515,270282,143748
1061,1709092,320842,96,0,High Volume,Growth,704,320842,0
1062,818257,121110,98,0,Low Volume,Stable,559,121110,0
1063,761492,150197,85,0,Stable,Stable,536,150197,0
1064,3798135,1264106,99,0,Stable,Growth,649,1139440,124666
1065,5867810,749293,98,0,High Volume,Stable,664,749293,0
1066,1871764,311439,93,0,Stable,Growth,647,311439,0
1067,4425201,1153329,94,0,Stable,Stable,593,885040,268289
1068,2647983,410100,88,0,Low Volume,Declining,499,410100,0
1069,1183402,372641,94,0,Stable,Stable,590,236680,135961
1070,2647474,1232212,86,1,Stable,Stable,505,529494,702718
1071,6786387,2623890,92,1,Stable,Stable,530,1357277,1266613
1072,1926738,674150,93,0,Stable,Stable,572,385347,288803
1073,6932388,2164463,96,0,Stable,Growth,623,2079716,84747
1074,500000,134788,91,0,Stable,Growth,615,134788,0
1075,3826733,512605,86,0,Unstable,Stable,489,512605,0
1076,2125755,962159,99,0,Stable,Stable,603,637726,324433
1077,1560933,252623,94,0,Stable,Growth,645,252623,0
1078,2133786,194364,91,0,Low Volume,Growth,583,194364,0
1079,500000,193753,94,0,Unstable,Stable,529,100000,93753
1080,1663214,214599,97,0,High Volume,Stable,627,214599,0
1081,2638418,573469,93,0,Stable,Growth,643,573469,0
1082,6467597,405701,89,0,Unstable,Growth,571,405701,0
1083,1309798,146279,94,0,Unstable,Declining,471,146279,0
1084,1038414,132856,93,0,High Volume,Growth,669,132856,0
1085,1327216,98857,92,0,Stable,Stable,576,98857,0
1086,4123949,1424806,98,0,High Volume,Stable,625,1237184,187622
1087,2579229,1100437,95,2,Low Volume,Stable,475,515845,584592
1088,1297814,282913,91,0,Low Volume,Declining,499,259562,23351
1089,2989492,1326017,86,0,Stable,Growth,609,896847,429170
1090,2142882,312874,91,2,Stable,Declining,447,312874,0
1091,4303400,845298,96,0,Low Volume,Stable,573,845298,0
1092,1130711,133234,89,0,Low Volume,Stable,547,133234,0
1093,1525557,502292,89,0,High Volume,Stable,612,457667,44625
1094,1448897,346201,95,0,Low Volume,Growth,621,346201,0
1095,614883,200438,97,0,High Volume,Stable,641,184464,15974
1096,2512770,986900,81,0,Stable,Growth,601,753831,233069
1097,2443261,722146,84,2,Stable,Declining,402,488652,233494
1098,1990887,661838,96,2,High Volume,Stable,578,398177,263661
1099,1643486,773856,87,0,High Volume,Growth,643,493045,280811
1100,639028,117951,93,1,Stable,Growth,594,117951,0
1101,1416194,299700,87,1,Unstable,Stable,475,283238,16462
1102,1507297,562171,96,0,High Volume,Stable,626,452189,109982
1103,1043591,339258,96,0,Unstable,Growth,585,208718,130540
1104,1742744,227149,93,0,Stable,Growth,617,227149,0
1105,2739376,600653,94,1,Unstable,Stable,474,547875,52778
1106,8965987,2335883,90,0,Unstable,Growth,562,1793197,542686
1107,2279946,544281,87,2,High Volume,Declining,501,455989,88292
1108,2436420,317280,94,0,Low Volume,Stable,569,317280,0
1109,1868120,870532,89,1,Stable,Declining,459,373624,496908
1110,500000,196522,92,0,Stable,Declining,526,100000,96522
1111,1941146,517529,97,0,Low Volume,Growth,621,517529,0
1112,2080636,740764,87,0,High Volume,Stable,605,624190,116574
1113,14226169,6455511,91,0,Low Volume,Growth,589,2845233,3610278
1114,1699953,189168,96,0,Stable,Growth,631,189168,0
1115,2523703,410525,96,0,Low Volume,Growth,603,410525,0
1116,1928457,567382,95,0,Stable,Growth,631,567382,0
1117,778448,318817,96,0,Stable,Growth,643,233534,85283
1118,4946834,328048,91,0,Stable,Declining,516,328048,0
1119,3618414,1783184,94,1,Low Volume,Growth,577,723682,1059502
1120,3733384,950923,83,0,Low Volume,Stable,520,746676,204247
1121,957892,202742,91,0,Stable,Growth,605,202742,0
1122,6090468,1106796,93,0,Stable,Growth,611,1106796,0
1123,645977,82983,86,0,High Volume,Declining,552,82983,0
1124,3170772,1287994,98,0,Low Volume,Growth,597,634154,653840
1125,11437003,5489034,95,3,Unstable,Stable,416,2287400,3201634
1126,897682,211979,99,1,High Volume,Stable,602,211979,0
1127,1260428,603227,92,1,Stable,Growth,595,252085,351142
1128,2147298,903387,97,0,Low Volume,Growth,623,644189,259198
1129,1325393,353181,95,0,Stable,Growth,651,353181,0
1130,573475,202615,89,0,Low Volume,Declining,474,114695,87920
1131,2094552,514721,89,1,High Volume,Declining,537,418910,95811
1132,847594,255486,92,0,Unstable,Stable,525,169518,85968
1133,2896095,220453,88,1,High Volume,Stable,591,220453,0
1134,950231,345237,93,1,Stable,Growth,571,190046,155191
1135,6851290,505427,96,0,High Volume,Stable,637,505427,0
1136,1059595,442580,95,1,Unstable,Declining,419,211919,230661
1137,1532408,645490,94,0,High Volume,Stable,616,459722,185768
1138,3801148,595582,89,1,Stable,Stable,508,595582,0
1139,740669,144911,94,0,Low Volume,Stable,557,144911,0
1140,2378470,634076,87,0,Stable,Growth,606,634076,0
1141,5641803,1796905,95,1,Low Volume,Declining,484,1128360,668545
1142,547991,98260,89,0,Stable,Declining,528,98260,0
1143,2298362,727705,96,1,High Volume,Declining,529,459672,268033
1144,2440970,449149,93,0,Stable,Growth,649,449149,0
1145,3705980,277840,88,0,High Volume,Stable,620,277840,0
1146,737071,37692,86,0,High Volume,Stable,602,37692,0
1147,689440,65854,98,0,Stable,Growth,646,65854,0
1148,3010309,1223729,96,1,Unstable,Declining,439,602061,621668
1149,2514508,1213612,96,0,High Volume,Stable,637,754352,459260
1150,2422703,586621,95,0,High Volume,Stable,615,586621,0
1151,2616004,734333,91,0,Unstable,Growth,577,523200,211133
1152,1150814,133588,91,1,Stable,Declining,491,133588,0
1153,2387609,711422,93,1,Stable,Stable,540,477521,233901
1154,2506651,288502,90,0,Unstable,Declining,468,288502,0
1155,1119641,363935,96,0,Low Volume,Growth,609,335892,28043
1156,8820769,4145465,89,0,Low Volume,Stable,527,1764153,2381312
1157,2896653,399924,95,0,Low Volume,Stable,555,399924,0
1158,764485,301248,89,0,Stable,Growth,607,229345,71903
1159,3352587,203087,89,0,Stable,Growth,618,203087,0
1160,909140,199078,91,2,Stable,Stable,481,181828,17250
1161,3721613,371554,99,0,Stable,Stable,583,371554,0
1162,5009649,1045083,88,0,High Volume,Declining,547,1001929,43154
1163,1028338,131721,98,1,High Volume,Stable,618,131721,0
1164,4285299,934141,82,0,Stable,Growth,587,857059,77082
1165,2758575,656224,86,1,Stable,Declining,486,551715,104509
1166,3827216,709053,98,0,Stable,Growth,650,709053,0
1167,9042393,3123965,93,0,Stable,Stable,595,1808478,1315487
1168,1629346,755175,98,0,Low Volume,Stable,572,325869,429306
1169,1084914,249821,96,1,Stable,Growth,593,216982,32839
1170,973242,132900,95,0,High Volume,Declining,577,132900,0
1171,1032354,177384,88,0,High Volume,Stable,600,177384,0
1172,1864155,809603,98,1,High Volume,Growth,663,559246,250357
1173,2604944,800337,95,0,Unstable,Growth,564,520988,279349
1174,2474014,630267,88,0,Stable,Stable,580,494802,135465
1175,3842934,450917,88,0,Low Volume,Stable,552,450917,0
1176,2003491,505636,83,0,High Volume,Growth,658,505636,0
1177,6342777,1112025,96,0,Low Volume,Stable,573,1112025,0
1178,1604423,761176,83,0,Low Volume,Growth,560,320884,440292
1179,17472440,7824710,98,0,Low Volume,Stable,576,3494488,4330222
1180,3270763,287030,95,0,Stable,Growth,615,287030,0
1181,998764,282145,96,0,Low Volume,Growth,610,282145,0
1182,841790,127343,93,0,Unstable,Declining,473,127343,0
1183,2916742,684996,90,0,Unstable,Growth,577,583348,101648
1184,1658178,737195,92,1,High Volume,Growth,631,497453,239742
1185,3510259,1008784,85,1,Stable,Growth,557,702051,306733
1186,2895273,580204,91,1,High Volume,Declining,547,579054,1150
1187,1870538,268515,80,0,Unstable,Growth,518,268515,0
1188,1007079,413050,87,0,Unstable,Stable,509,201415,211635
1189,590144,195357,84,0,Stable,Growth,593,118028,77329
1190,1387186,361542,95,1,Unstable,Growth,551,277437,84105
1191,3933810,581684,96,1,Low Volume,Stable,532,581684,0
1192,2353173,471601,98,1,Stable,Stable,537,470634,967
1193,731907,352728,93,0,Stable,Stable,563,146381,206347
1194,2277399,646873,90,1,Stable,Stable,534,455479,191394
1195,2698628,621534,87,1,Unstable,Stable,468,539725,81809
1196,977657,278280,90,1,High Volume,Growth,625,278280,0
1197,2242227,898112,91,0,Low Volume,Stable,542,448445,449667
1198,2077274,421788,86,1,Stable,Growth,554,415454,6334
1199,794624,103633,95,0,Low Volume,Declining,521,103633,0
1200,2639843,826855,90,0,High Volume,Stable,616,791952,34903
1201,3105321,1084819,98,0,Stable,Stable,590,621064,463755
1202,4715856,1748277,97,0,Unstable,Stable,537,943171,805106
1203,4606789,2058748,84,1,Stable,Declining,462,921357,1137391
1204,658595,142934,94,0,Stable,Growth,645,142934,0
1205,936346,78569,95,1,Low Volume,Declining,484,78569,0
1206,2993723,1440750,96,0,Stable,Growth,637,898116,542634
1207,2990732,734988,96,0,Stable,Stable,599,598146,136842
1208,2993752,989333,95,0,Stable,Stable,602,898125,91208
1209,43236050,15125587,90,0,Unstable,Growth,561,8647210,6478377
1210,3130529,926421,88,1,Low Volume,Growth,538,626105,300316
1211,4918197,700183,97,0,High Volume,Growth,706,700183,0
1212,4253282,1657990,91,2,Low Volume,Stable,470,850656,807334
1213,3338770,1374533,98,0,Stable,Growth,625,1001631,372902
1214,1540757,460438,98,0,High Volume,Stable,656,460438,0
1215,3638840,981950,99,0,Low Volume,Declining,533,727768,254182
1216,1068472,108206,90,0,High Volume,Stable,621,108206,0
1217,1640555,144005,96,0,Stable,Growth,645,144005,0
1218,1344737,272718,89,0,High Volume,Stable,606,272718,0
1219,2116976,401973,98,1,Unstable,Declining,439,401973,0
1220,12631785,6052462,96,0,Low Volume,Declining,501,2526357,3526105
1221,500000,201315,91,1,High Volume,Stable,597,100000,101315
1222,3433217,1191209,93,0,Stable,Growth,635,1029965,161244
1223,545701,154402,95,0,Stable,Growth,625,154402,0
1224,1359265,170337,79,0,High Volume,Stable,573,170337,0
1225,4738165,2323148,81,0,Unstable,Stable,502,947633,1375515
1226,2087388,456654,95,0,Low Volume,Growth,618,456654,0
1227,837188,82142,91,0,Unstable,Growth,547,82142,0
1228,1118789,304545,83,0,High Volume,Stable,617,304545,0
1229,3414966,1513851,91,0,Stable,Stable,576,682993,830858
1230,1105388,496630,91,0,High Volume,Growth,678,331616,165014
1231,2357629,129516,93,0,Stable,Stable,593,129516,0
1232,2056380,922971,87,0,Low Volume,Growth,582,411276,511695
1233,1177283,202690,86,0,High Volume,Declining,578,202690,0
1234,11019261,744214,99,0,Stable,Stable,580,744214,0
1235,3292426,1420700,97,2,Stable,Growth,578,658485,762215
1236,500000,219370,97,0,Stable,Stable,590,100000,119370
1237,2301711,732644,96,0,High Volume,Declining,604,690513,42131
1238,1167728,360238,93,0,High Volume,Declining,561,233545,126693
1239,3921351,1630906,89,1,Stable,Growth,592,784270,846636
1240,1051768,424745,88,0,Stable,Growth,597,210353,214392
1241,1808866,814980,92,0,Low Volume,Stable,531,361773,453207
1242,2969754,887173,94,0,High Volume,Growth,673,887173,0
1243,3963366,1923981,97,0,High Volume,Stable,621,1189009,734972
1244,759004,378186,87,0,Low Volume,Stable,534,151800,226386
1245,1517233,155433,80,1,High Volume,Stable,548,155433,0
1246,1355992,586188,82,0,Stable,Growth,579,271198,314990
1247,1175656,323211,85,1,Stable,Growth,575,235131,88080
1248,8140510,1826770,81,0,High Volume,Stable,576,1628102,198668
1249,2741417,893380,97,1,Stable,Stable,550,548283,345097
1250,723093,54365,95,0,Unstable,Growth,590,54365,0
1251,4132072,1148334,88,1,High Volume,Growth,606,1148334,0
1252,10828856,4785280,99,0,Stable,Declining,554,2165771,2619509
1253,4528821,661469,87,0,Stable,Growth,619,661469,0
1254,588013,142226,98,1,Unstable,Growth,541,117602,24624
1255,1345953,636321,82,0,High Volume,Stable,585,269190,367131
1256,5463111,1326737,86,0,High Volume,Stable,599,1092622,234115
1257,1125642,237809,97,0,High Volume,Growth,683,237809,0
1258,2827930,702010,89,1,Stable,Growth,593,565586,136424
1259,3684728,1045555,88,0,Stable,Growth,616,1045555,0
1260,944542,315851,94,2,Stable,Growth,564,188908,126943
1261,1890553,775716,89,1,Stable,Growth,558,378110,397606
1262,500000,126723,95,0,Unstable,Declining,484,100000,26723
1263,873698,365089,95,0,Stable,Growth,649,262109,102980
1264,1620014,470086,95,0,Low Volume,Growth,614,470086,0
1265,730711,147835,94,1,High Volume,Growth,641,147835,0
1266,7318596,2532804,84,1,Stable,Declining,467,1463719,1069085
1267,631521,235542,89,0,Unstable,Declining,470,126304,109238
1268,1394386,419880,92,0,Unstable,Growth,569,278877,141003
1269,2201374,166153,92,0,Low Volume,Declining,492,166153,0
1270,6280867,794199,95,0,Unstable,Growth,588,794199,0
1271,628638,112139,92,0,Stable,Growth,625,112139,0
1272,5027991,890867,96,0,Unstable,Stable,544,890867,0
1273,1999058,705746,87,0,Low Volume,Growth,566,399811,305935
1274,904188,52675,95,0,High Volume,Growth,699,52675,0
1275,2869599,1119307,84,0,Stable,Stable,539,573919,545388
1276,2325040,393871,95,0,Stable,Stable,591,393871,0
1277,1226686,232469,80,0,High Volume,Declining,521,232469,0
1278,2096630,602906,93,0,Stable,Growth,617,602906,0
1279,1456795,214391,95,0,High Volume,Growth,687,214391,0
1280,2171251,972747,91,1,High Volume,Growth,636,651375,321372
1281,3367579,297748,91,2,Stable,Growth,544,297748,0
1282,7051941,1762788,96,0,High Volume,Growth,681,1762788,0
1283,736561,318371,91,0,Unstable,Stable,513,147312,171059
1284,10923497,3573401,85,1,Low Volume,Growth,526,2184699,1388702
1285,500000,90774,92,0,Unstable,Growth,584,90774,0
1286,1756040,420294,88,1,Low Volume,Declining,459,351208,69086
1287,3174478,1168247,98,0,Low Volume,Growth,626,952343,215904
1288,2482542,1211399,99,1,Stable,Stable,537,496508,714891
1289,1204820,544473,96,0,High Volume,Stable,640,361446,183027
1290,1678653,342604,90,0,High Volume,Declining,552,335730,6874
1291,1336546,667189,82,0,Low Volume,Declining,468,267309,399880
1292,1237382,63821,89,0,Stable,Growth,610,63821,0
1293,3912479,244269,92,0,Stable,Growth,614,244269,0
1294,2638213,1109971,89,0,High Volume,Growth,673,791463,318508
1295,1139013,159186,98,0,High Volume,Growth,689,159186,0
1296,4072143,314965,90,0,High Volume,Growth,674,314965,0
1297,2535343,397330,96,1,Low Volume,Growth,575,397330,0
1298,3799157,918427,95,0,Stable,Stable,589,759831,158596
1299,3281145,1242749,91,0,Stable,Declining,533,656229,586520
1300,1021522,338074,89,1,High Volume,Declining,529,204304,133770
1301,1266611,198769,97,0,High Volume,Growth,681,198769,0
1302,3605009,996683,82,0,Stable,Stable,559,721001,275682
1303,3230981,1508210,84,0,High Volume,Declining,543,646196,862014
1304,1949881,812620,85,0,Low Volume,Declining,481,389976,422644
1305,2177879,425635,92,0,Low Volume,Growth,602,425635,0
1306,5510313,2711179,92,1,High Volume,Growth,635,1653093,1058086
1307,1235199,455639,90,2,Low Volume,Stable,448,247039,208600
1308,3071504,239891,93,0,Stable,Stable,566,239891,0
1309,1686635,111018,88,1,Unstable,Growth,506,111018,0
1310,1665865,209538,93,0,Low Volume,Growth,619,209538,0
1311,4775558,1802941,91,0,Stable,Stable,553,955111,847830
1312,3837505,509170,96,0,Stable,Declining,518,509170,0
1313,3801125,1064958,94,0,High Volume,Growth,695,1064958,0
1314,5634298,518170,90,0,Low Volume,Declining,500,518170,0
1315,2016357,936394,90,0,Stable,Growth,603,604907,331487
1316,3421407,700644,92,0,Stable,Growth,620,700644,0
1317,1546936,709517,83,0,Stable,Growth,593,309387,400130
1318,2569786,1221147,97,0,High Volume,Growth,709,1027914,193233
1319,1786708,94263,89,0,Low Volume,Growth,586,94263,0
1320,2142742,554672,89,0,Low Volume,Stable,520,428548,126124
1321,3191896,195010,97,0,High Volume,Declining,592,195010,0
1322,1030365,472847,97,0,Stable,Growth,634,309109,163738
1323,10574012,2995442,89,1,High Volume,Stable,577,2114802,880640
1324,886633,74233,88,0,High Volume,Growth,668,74233,0
1325,750616,74780,96,0,Stable,Declining,538,74780,0
1326,5007707,1114611,91,0,Unstable,Growth,580,1001541,113070
1327,3735268,1767175,93,0,Stable,Growth,616,1120580,646595
1328,3266716,1181928,88,0,Stable,Growth,619,980014,201914
1329,3277778,1443627,99,0,Unstable,Declining,476,655555,788072
1330,1963428,421951,97,2,Low Volume,Stable,494,392685,29266
1331,967235,67171,96,1,High Volume,Stable,590,67171,0
1332,2106722,1029013,95,0,High Volume,Growth,680,632016,396997
1333,1153453,66586,96,0,High Volume,Growth,696,66586,0
1334,4325749,2060974,92,0,Stable,Stable,587,865149,1195825
1335,1762694,380574,95,1,Low Volume,Stable,512,352538,28036
1336,1024384,55871,93,0,Low Volume,Growth,607,55871,0
1337,1533236,552150,98,1,High Volume,Stable,601,459970,92180
1338,2758907,1355294,93,0,Stable,Declining,512,551781,803513
1339,1263025,611975,94,0,High Volume,Growth,684,378907,233068
1340,1027073,125736,90,0,High Volume,Declining,566,125736,0
1341,2409548,317004,89,0,High Volume,Stable,633,317004,0
1342,2412015,734441,98,0,Unstable,Growth,594,482403,252038
1343,1321721,445139,96,0,Stable,Declining,536,264344,180795
1344,1360237,520614,85,1,Unstable,Stable,469,272047,248567
1345,2387220,313854,86,0,Low Volume,Stable,536,313854,0
1346,622521,299777,95,0,Low Volume,Stable,570,124504,175273
1347,643083,216997,91,0,Low Volume,Growth,599,128616,88381
1348,1115981,481179,97,0,High Volume,Stable,642,334794,146385
1349,1671517,489804,94,0,Low Volume,Stable,541,334303,155501
1350,2542672,601150,91,0,High Volume,Growth,676,601150,0
1351,6454480,3160967,90,0,Unstable,Stable,495,1290896,1870071
1352,3937780,1228409,95,1,Low Volume,Stable,517,787556,440853
1353,1744623,767797,93,0,Unstable,Growth,577,348924,418873
1354,1952824,935367,89,0,Unstable,Growth,567,390564,544803
1355,889110,314665,81,0,Stable,Growth,594,177822,136843
1356,1953610,580266,88,0,Unstable,Growth,536,390722,189544
1357,1573909,81182,93,1,Stable,Declining,505,81182,0
1358,2566811,174566,89,0,Stable,Growth,632,174566,0
1359,1022964,143607,89,0,Low Volume,Stable,522,143607,0
1360,3004066,401655,95,0,Stable,Growth,631,401655,0
1361,6757686,1112595,96,1,High Volume,Growth,629,1112595,0
1362,1817535,340280,98,0,Low Volume,Stable,565,340280,0
1363,2734254,579742,82,0,High Volume,Declining,531,546850,32892
1364,3443900,823925,77,1,Stable,Stable,494,688780,135145
1365,1438374,135912,91,0,Stable,Stable,576,135912,0
1366,2372071,163822,86,0,Low Volume,Stable,523,163822,0
1367,2002834,707551,83,0,Low Volume,Growth,584,400566,306985
1368,2143908,625594,89,0,Stable,Growth,630,625594,0
1369,1068314,266934,88,0,Stable,Declining,500,213662,53272
1370,2022021,678384,77,0,Low Volume,Declining,471,404404,273980
1371,2953196,1247595,92,0,Stable,Declining,527,590639,656956
1372,6330659,1534943,84,0,Stable,Declining,502,1266131,268812
1373,4271248,1445834,89,0,High Volume,Growth,663,1281374,164460
1374,11101002,5318573,97,1,Unstable,Growth,541,2220200,3098373
1375,1073164,459133,85,1,Stable,Growth,571,214632,244501
1376,3984238,962992,82,0,Low Volume,Growth,582,796847,166145
1377,2295988,780917,87,1,High Volume,Stable,571,459197,321720
1378,11431032,1482398,89,0,Stable,Growth,637,1482398,0
1379,1038576,313894,85,0,Stable,Growth,606,311572,2322
1380,1012793,497887,90,0,High Volume,Growth,690,303837,194050
1381,1227495,347678,90,0,Low Volume,Declining,497,245499,102179
1382,500000,233719,94,0,Low Volume,Growth,607,150000,83719
1383,1301979,303753,91,0,High Volume,Growth,663,303753,0
1384,1080240,539558,95,0,Stable,Stable,589,216048,323510
1385,2236259,694692,91,0,High Volume,Growth,656,670877,23815
1386,2606203,179883,90,0,Stable,Declining,511,179883,0
1387,8894438,2793206,96,1,Stable,Stable,530,1778887,1014319
1388,4241125,736080,96,0,Stable,Growth,624,736080,0
1389,1249779,80756,90,1,High Volume,Growth,647,80756,0
1390,966337,405266,86,0,High Volume,Growth,659,289901,115365
1391,2938869,511593,89,0,Low Volume,Growth,599,511593,0
1392,689563,281650,93,1,Unstable,Growth,544,137912,143738
1393,8581910,1542151,96,0,Unstable,Stable,509,1542151,0
1394,5093889,700139,97,0,Low Volume,Growth,628,700139,0
1395,1362265,665155,92,0,High Volume,Growth,657,408679,256476
1396,503577,107131,88,0,High Volume,Stable,598,100715,6416
1397,5856706,1877773,92,0,Stable,Growth,625,1757011,120762
1398,1809151,587054,92,0,High Volume,Growth,686,542745,44309
1399,5337421,1613038,95,0,Stable,Stable,586,1067484,545554
1400,553744,255615,92,0,Unstable,Growth,585,110748,144867
1401,1227512,433924,90,0,High Volume,Growth,676,368253,65671
1402,1991094,461296,83,1,Low Volume,Growth,523,398218,63078
1403,2058698,901856,96,0,High Volume,Stable,648,617609,284247
1404,1383252,181868,89,1,Stable,Stable,519,181868,0
1405,3263399,962398,94,0,Stable,Growth,617,962398,0
1406,843997,403218,90,0,Stable,Stable,578,168799,234419
1407,1769303,586398,88,1,Unstable,Stable,468,353860,232538
1408,2183056,911722,83,0,Stable,Growth,603,654916,256806
1409,2992295,1029656,91,0,Low Volume,Stable,526,598459,431197
1410,3503566,1498534,92,0,Low Volume,Growth,582,700713,797821
1411,806361,383037,98,0,Low Volume,Growth,604,241908,141129
1412,581118,100426,87,1,Low Volume,Declining,442,100426,0
1413,5510365,696221,94,0,Stable,Stable,565,696221,0
1414,2586591,692678,94,1,Low Volume,Stable,501,517318,175360
1415,1089480,398573,88,0,Stable,Declining,501,217896,180677
1416,6857967,1044030,83,0,Stable,Growth,590,1044030,0
1417,2175001,112764,83,1,High Volume,Growth,629,112764,0
1418,5093306,1040668,86,0,High Volume,Declining,562,1018661,22007
1419,2092803,1017074,96,0,Stable,Growth,646,627840,389234
1420,10309727,3739703,95,0,High Volume,Stable,620,3092918,646785
1421,8074913,1862046,82,3,Stable,Declining,361,1614982,247064
1422,1624692,222029,94,1,Stable,Growth,584,222029,0
1423,4313485,906869,94,0,High Volume,Declining,586,862697,44172
1424,3322742,420087,88,1,Stable,Stable,515,420087,0
1425,5926268,579812,96,0,Stable,Declining,525,579812,0
1426,916265,419681,88,2,High Volume,Growth,571,183253,236428
1427,3432643,1712692,83,1,Stable,Stable,516,686528,1026164
1428,4623856,572671,92,1,Stable,Declining,487,572671,0
1429,500000,37268,85,0,Stable,Growth,587,37268,0
1430,769421,152637,94,0,Low Volume,Growth,599,152637,0
1431,500000,128873,97,2,High Volume,Growth,600,128873,0
1432,1598337,227235,92,0,High Volume,Declining,591,227235,0
1433,3520219,653498,83,0,Stable,Growth,599,653498,0
1434,6595417,925943,96,0,Low Volume,Growth,616,925943,0
1435,2103842,838207,82,1,Stable,Stable,519,420768,417439
1436,7296406,2704486,97,0,Stable,Stable,611,2188921,515565
1437,657315,220679,89,0,Stable,Stable,557,131463,89216
1438,507521,113811,92,0,Stable,Stable,569,101504,12307
1439,1896578,870659,81,0,Unstable,Stable,495,379315,491344
1440,2695926,1311001,90,0,Low Volume,Growth,604,808777,502224
1441,1931571,247507,96,0,Low Volume,Declining,504,247507,0
1442,500000,75178,89,1,Stable,Growth,560,75178,0
1443,1846318,529033,93,0,Stable,Declining,549,369263,159770
1444,698314,63590,95,0,Stable,Growth,641,63590,0
1445,3387958,834799,95,0,Stable,Growth,634,834799,0
1446,2658516,828941,96,0,Stable,Stable,574,531703,297238
1447,934808,266358,96,0,High Volume,Declining,607,266358,0
1448,1314421,261450,87,0,High Volume,Growth,664,261450,0
1449,849692,249895,95,0,High Volume,Growth,689,249895,0
1450,1885789,907933,98,0,Low Volume,Stable,555,377157,530776
1451,4257164,607531,87,0,High Volume,Declining,563,607531,0
1452,901143,310601,90,0,Unstable,Growth,560,180228,130373
1453,2967520,206327,91,0,Stable,Growth,643,206327,0
1454,1297298,103638,91,1,High Volume,Stable,567,103638,0
1455,1051472,313678,90,1,Low Volume,Growth,547,210294,103384
1456,1820052,176950,92,0,Stable,Growth,642,176950,0
1457,866144,52017,91,0,Stable,Declining,518,52017,0
1458,1273247,161933,86,0,Stable,Stable,578,161933,0
1459,760474,231323,95,0,Stable,Growth,647,228142,3181
1460,9547407,3499157,84,0,Stable,Declining,488,1909481,1589676
1461,2039491,287803,93,0,Stable,Stable,568,287803,0
1462,1132819,397299,88,2,Stable,Stable,467,226563,170736
1463,2352958,310860,93,0,Stable,Stable,578,310860,0
1464,1812355,590929,91,1,High Volume,Declining,524,362471,228458
1465,1661488,391084,93,0,Low Volume,Declining,494,332297,58787
1466,3240808,1115518,96,0,Unstable,Growth,575,648161,467357
1467,3634587,1809202,92,0,Low Volume,Growth,578,726917,1082285
1468,1297045,612228,88,0,Stable,Growth,628,389113,223115
1469,1250864,64953,83,0,Unstable,Growth,546,64953,0
1470,1591136,713541,88,0,Stable,Stable,550,318227,395314
1471,500000,39960,98,0,Low Volume,Growth,619,39960,0
1472,589982,282525,91,0,Low Volume,Declining,501,117996,164529
1473,5917943,1046420,84,0,Low Volume,Growth,559,1046420,0
1474,7392483,1640508,93,0,Stable,Growth,632,1640508,0
1475,1624598,148224,93,0,High Volume,Growth,667,148224,0
1476,3144752,316119,95,0,High Volume,Growth,666,316119,0
1477,2543369,958935,96,0,Low Volume,Stable,563,508673,450262
1478,23279988,11056819,83,1,High Volume,Growth,628,6983996,4072823
1479,4855681,1577304,91,0,High Volume,Stable,614,1456704,120600
1480,1789892,666077,82,0,High Volume,Growth,645,536967,129110
1481,923169,362701,91,0,Stable,Stable,572,184633,178068
1482,548445,92285,91,0,Stable,Growth,627,92285,0
1483,2333246,164152,92,1,Stable,Stable,543,164152,0
1484,1082647,55045,93,0,Low Volume,Growth,598,55045,0
1485,635519,132056,94,0,High Volume,Declining,563,127103,4953
1486,1182027,187539,97,1,High Volume,Declining,535,187539,0
1487,834645,65138,94,0,Stable,Growth,645,65138,0
1488,7646154,1000023,93,0,High Volume,Declining,581,1000023,0
1489,4014052,425588,92,2,Low Volume,Growth,529,425588,0
1490,1970153,909610,94,0,Stable,Declining,552,394030,515580
1491,6478213,732817,92,0,Stable,Growth,621,732817,0
1492,2109359,615810,95,0,High Volume,Growth,665,615810,0
1493,995472,315463,90,0,Low Volume,Declining,485,199094,116369
1494,6705906,1975360,97,0,Stable,Growth,661,1975360,0
1495,3051452,288592,89,0,Stable,Stable,582,288592,0
1496,864756,167295,90,0,Stable,Stable,568,167295,0
1497,1702706,124420,91,0,Unstable,Declining,461,124420,0
1498,984122,224430,87,0,High Volume,Declining,579,196824,27606
1499,655898,88461,83,2,High Volume,Growth,582,88461,0
1500,4159652,1259271,84,0,High Volume,Stable,611,1247895,11376
1501,9134174,3304413,94,0,Low Volume,Growth,590,1826834,1477579
1502,647676,187472,85,0,High Volume,Growth,649,187472,0
1503,3110753,763399,97,0,Stable,Stable,580,622150,141249
1504,1178185,264267,92,1,Low Volume,Growth,538,235637,28630
1505,1342843,575759,93,1,Low Volume,Growth,554,268568,307191
1506,1234387,183573,95,0,Stable,Growth,652,183573,0
1507,993319,377857,93,0,Stable,Growth,623,297995,79862
1508,2061238,805670,95,0,Unstable,Stable,513,412247,393423
1509,1019925,243395,94,1,High Volume,Growth,624,243395,0
1510,2461707,452425,95,0,Stable,Declining,520,452425,0
1511,1904651,498530,83,0,Stable,Growth,605,498530,0
1512,1637763,150586,96,0,High Volume,Growth,674,150586,0
1513,959290,67792,86,0,Stable,Growth,602,67792,0
1514,1249911,125268,93,0,Low Volume,Stable,561,125268,0
1515,3628439,486992,93,2,Stable,Stable,502,486992,0
1516,2960100,819591,93,0,High Volume,Growth,682,819591,0
1517,907053,391948,94,0,Unstable,Growth,570,181410,210538
1518,2146750,334977,88,0,Stable,Declining,516,334977,0
1519,3616834,1702888,95,1,Stable,Growth,602,1085050,617838
1520,521506,250171,92,0,Low Volume,Growth,579,104301,145870
1521,3062335,1474536,81,1,High Volume,Stable,557,612467,862069
1522,1166946,498173,94,0,High Volume,Growth,676,350083,148090
1523,3129798,668904,95,0,High Volume,Growth,669,668904,0
1524,1076680,89050,87,1,Stable,Stable,537,89050,0
1525,500000,152984,92,1,Unstable,Declining,407,100000,52984
1526,539267,162539,91,0,Stable,Stable,573,107853,54686
1527,2060518,891152,94,0,High Volume,Growth,673,618155,272997
1528,2440657,1215925,94,0,Low Volume,Declining,493,488131,727794
1529,961785,268021,90,1,Low Volume,Stable,488,192357,75664
1530,3304759,678605,95,1,High Volume,Stable,579,660951,17654
1531,524806,70143,83,0,Low Volume,Stable,516,70143,0
1532,1880665,98095,87,0,Stable,Stable,579,98095,0
1533,752523,210030,85,0,High Volume,Stable,585,150504,59526
1534,1177061,353099,91,1,Stable,Stable,541,235412,117687
1535,2059387,867460,94,0,High Volume,Declining,601,617816,249644
1536,996166,275997,91,0,Low Volume,Growth,607,275997,0
1537,1457678,674046,98,0,Low Volume,Growth,613,437303,236743
1538,4434983,1475242,87,0,Stable,Growth,610,1330494,144748
1539,1249791,535100,95,0,Stable,Stable,595,249958,285142
1540,3869182,451672,92,0,High Volume,Stable,627,451672,0
1541,803100,349269,92,0,Stable,Declining,546,160620,188649
1542,3029304,1071812,100,0,High Volume,Growth,720,1071812,0
1543,6282351,795376,88,0,Stable,Stable,583,795376,0
1544,500000,67697,95,0,High Volume,Growth,676,67697,0
1545,1048094,489382,83,0,Stable,Stable,534,209618,279764
1546,3146048,202910,91,0,High Volume,Growth,655,202910,0
1547,1685485,435092,91,0,High Volume,Declining,590,337097,97995
1548,2668205,509798,80,0,Stable,Stable,550,509798,0
1549,1222993,427173,94,1,Stable,Stable,557,244598,182575
1550,2124978,909136,91,0,Stable,Growth,622,637493,271643
1551,1750581,371421,97,1,High Volume,Stable,619,371421,0
1552,5046602,1221812,95,0,High Volume,Growth,666,1221812,0
1553,2430328,1195388,98,1,High Volume,Growth,663,729098,466290
1554,2597557,1046198,85,0,Low Volume,Stable,520,519511,526687
1555,1426163,647110,85,0,High Volume,Growth,668,427848,219262
1556,1342327,332149,92,0,Low Volume,Growth,600,332149,0
1557,1402762,217897,91,0,Low Volume,Growth,592,217897,0
1558,2718421,639749,96,0,Low Volume,Stable,540,543684,96065
1559,1415810,527023,90,0,Low Volume,Growth,609,424743,102280
1560,2500046,248114,95,0,Stable,Stable,581,248114,0
1561,10431291,1791168,91,1,Low Volume,Growth,549,1791168,0
1562,3980427,282555,89,1,Low Volume,Growth,563,282555,0
1563,1527558,373574,98,0,Stable,Growth,660,373574,0
1564,5183397,2189211,92,0,Low Volume,Growth,597,1036679,1152532
1565,1430507,87402,96,0,Stable,Growth,647,87402,0
1566,500000,176948,96,1,High Volume,Growth,666,150000,26948
1567,885166,415694,86,1,Low Volume,Growth,542,177033,238661
1568,500000,78309,89,0,Low Volume,Growth,569,78309,0
1569,1496724,542017,96,1,Stable,Growth,596,299344,242673
1570,2012191,983551,96,0,Stable,Declining,525,402438,581113
1571,7580956,3661792,99,0,Stable,Stable,594,1516191,2145601
1572,2575468,401047,98,1,Low Volume,Growth,563,401047,0
1573,1663975,158326,92,0,High Volume,Growth,693,158326,0
1574,3849772,449373,84,0,Low Volume,Growth,572,449373,0
1575,500000,182958,87,1,High Volume,Growth,634,150000,32958
1576,2394037,901574,98,0,High Volume,Declining,591,478807,422767
1577,3673635,1298286,94,0,Low Volume,Growth,615,1102090,196196
1578,607514,122253,98,0,High Volume,Growth,707,122253,0
1579,4950520,625744,87,0,Low Volume,Stable,541,625744,0
1580,2599415,809308,92,2,Unstable,Declining,381,519883,289425
1581,1422277,380681,88,0,Stable,Stable,577,284455,96226
1582,3289432,1243324,88,0,Unstable,Growth,568,657886,585438
1583,12195216,3031877,77,1,Stable,Declining,440,2439043,592834
1584,2293278,464132,87,0,High Volume,Stable,616,464132,0
1585,2418303,440289,96,0,Stable,Growth,620,440289,0
1586,1373004,199308,92,0,Low Volume,Growth,584,199308,0
1587,1004625,170370,94,0,Stable,Stable,583,170370,0
1588,3852638,357038,89,0,Stable,Growth,599,357038,0
1589,999622,206008,94,0,High Volume,Stable,624,206008,0
1590,2099591,139531,93,1,Low Volume,Growth,572,139531,0
1591,1353053,181155,96,0,Stable,Stable,579,181155,0
1592,2908604,1122857,85,1,Stable,Growth,559,581720,541137
1593,2589382,508713,93,0,Low Volume,Stable,569,508713,0
1594,4547244,1594749,89,1,Stable,Declining,465,909448,685301
1595,1318476,491261,92,1,High Volume,Stable,579,263695,227566
1596,1597739,497749,96,0,Stable,Declining,555,319547,178202
1597,906176,436246,93,1,High Volume,Stable,594,181235,255011
1598,1389654,82890,94,0,Low Volume,Stable,558,82890,0
1599,2681375,1025341,98,0,Stable,Growth,657,804412,220929
1600,3633078,1749160,91,0,Stable,Growth,634,1089923,659237
1601,948150,415311,97,0,Stable,Growth,636,284445,130866
1602,3975594,499143,96,0,High Volume,Growth,698,499143,0
1603,5864984,1155807,77,0,Stable,Growth,575,1155807,0
1604,2760018,352187,96,0,Low Volume,Growth,626,352187,0
1605,8898886,2852883,88,2,Low Volume,Growth,521,1779777,1073106
1606,1067648,395547,92,1,Stable,Growth,604,320294,75253
1607,732542,141149,92,2,Unstable,Growth,494,141149,0
1608,500000,146389,86,0,Stable,Stable,559,100000,46389
1609,6562193,2368389,93,1,High Volume,Growth,622,1968657,399732
1610,3346724,801885,94,0,Stable,Stable,591,669344,132541
1611,1896522,823673,86,0,Unstable,Declining,459,379304,444369
1612,2480510,985252,90,0,Stable,Growth,603,744153,241099
1613,805814,63739,89,1,High Volume,Stable,557,63739,0
1614,14028501,4622481,95,0,Unstable,Stable,542,2805700,1816781
1615,2198700,342770,96,0,Low Volume,Growth,624,342770,0
1616,2164102,651142,96,1,High Volume,Growth,663,649230,1912
1617,3543457,1702985,97,1,Stable,Growth,620,1063037,639948
1618,2913330,1298115,96,0,High Volume,Growth,674,873999,424116
1619,2371675,550305,92,0,High Volume,Stable,643,550305,0
1620,1053491,190873,75,0,High Volume,Growth,641,190873,0
1621,2891178,449528,89,0,High Volume,Declining,570,449528,0
1622,8936187,2588203,96,1,Stable,Stable,560,1787237,800966
1623,5817237,589936,89,1,High Volume,Stable,571,589936,0
1624,7092506,2107707,82,1,Low Volume,Declining,430,1418501,689206
1625,1317211,66651,90,1,Low Volume,Growth,554,66651,0
1626,898351,175836,93,0,Stable,Growth,622,175836,0
1627,1792946,267096,96,0,High Volume,Declining,579,267096,0
1628,2073150,1009725,97,1,Unstable,Declining,460,414630,595095
1629,4758073,1795026,94,0,Stable,Growth,623,1427421,367605
1630,511974,106155,98,2,Stable,Stable,509,102394,3761
1631,6740470,618642,93,1,High Volume,Growth,643,618642,0
1632,1747320,493723,97,1,High Volume,Growth,641,493723,0
1633,1409147,205808,87,0,Low Volume,Stable,515,205808,0
1634,882326,257104,94,0,Stable,Growth,625,257104,0
1635,527611,224716,92,0,Unstable,Declining,474,105522,119194
1636,3830617,1253020,94,0,Unstable,Stable,503,766123,486897
1637,2102535,704780,88,0,High Volume,Stable,595,420507,284273
1638,706467,207322,95,0,Unstable,Growth,566,141293,66029
1639,703580,328761,98,0,Unstable,Declining,468,140716,188045
1640,1515676,711392,92,0,Low Volume,Growth,587,303135,408257
1641,7536114,2115579,92,0,Stable,Stable,588,1507222,608357
1642,1610938,302199,96,0,High Volume,Stable,627,302199,0
1643,595696,152983,94,1,High Volume,Growth,656,152983,0
1644,1628884,218191,92,0,High Volume,Declining,568,218191,0
1645,1594102,536184,87,1,Low Volume,Growth,559,318820,217364
1646,500000,137521,92,0,Unstable,Stable,535,100000,37521
1647,1898480,183175,83,0,Low Volume,Stable,508,183175,0
1648,1648296,229017,89,0,Low Volume,Growth,581,229017,0
1649,3460643,919958,95,0,Stable,Declining,552,692128,227830
1650,8702883,3911207,98,3,Stable,Growth,512,1740576,2170631
1651,4882911,1488682,96,1,Stable,Growth,603,1464873,23809
1652,1599000,570349,86,0,High Volume,Growth,639,479700,90649
1653,818132,165723,85,1,Low Volume,Growth,548,163626,2097
1654,15536270,4771734,97,0,High Volume,Stable,642,4660881,110853
1655,2078953,522484,93,0,High Volume,Growth,670,522484,0
1656,2004978,694942,93,0,Stable,Growth,625,601493,93449
1657,1944859,141506,94,2,Stable,Stable,499,141506,0
1658,2323227,631883,87,0,Low Volume,Declining,481,464645,167238
1659,1766502,323617,93,0,Stable,Stable,580,323617,0
1660,1253024,246574,92,0,High Volume,Growth,676,246574,0
1661,1280182,617576,97,0,Unstable,Growth,595,256036,361540
1662,1931481,255366,90,1,Low Volume,Stable,517,255366,0
1663,1283704,243981,91,0,Low Volume,Declining,497,243981,0
1664,1120991,313263,88,1,Low Volume,Stable,509,224198,89065
1665,2158975,946413,98,0,High Volume,Growth,686,647692,298721
1666,1616895,384015,94,0,Unstable,Growth,570,323379,60636
1667,6604055,2540840,90,1,Unstable,Growth,514,1320811,1220029
1668,500000,217684,85,0,High Volume,Growth,644,150000,67684
1669,4747864,899755,86,0,High Volume,Stable,594,899755,0
1670,5372845,1218226,87,0,Unstable,Declining,454,1074569,143657
1671,500000,105225,91,1,High Volume,Declining,525,100000,5225
1672,1507329,640291,95,0,Low Volume,Declining,525,301465,338826
1673,1473052,103049,97,2,High Volume,Declining,517,103049,0
1674,643058,121403,87,1,Low Volume,Growth,527,121403,0
1675,1064214,378577,94,0,Low Volume,Stable,537,212842,165735
1676,815486,248274,99,0,Unstable,Growth,582,163097,85177
1677,8055103,1984215,87,1,Low Volume,Growth,525,1611020,373195
1678,4191389,1227979,94,1,High Volume,Declining,558,838277,389702
1679,5483445,761722,88,0,Stable,Growth,606,761722,0
1680,3531869,861149,90,0,Stable,Growth,625,861149,0
1681,803521,221584,88,0,Stable,Growth,610,221584,0
1682,1303266,593683,86,0,Stable,Growth,598,260653,333030
1683,2932892,490895,93,0,High Volume,Growth,672,490895,0
1684,745863,328570,98,0,Stable,Stable,595,149172,179398
1685,3507446,1192211,86,1,Stable,Declining,486,701489,490722
1686,1635959,96772,84,0,Low Volume,Stable,532,96772,0
1687,1469075,552496,96,0,Stable,Stable,608,440722,111774
1688,3501731,231108,87,0,Stable,Stable,575,231108,0
1689,2828934,1411133,95,0,Low Volume,Growth,625,848680,562453
1690,1485448,657588,95,0,Low Volume,Declining,519,297089,360499
1691,5012593,921338,95,0,Stable,Growth,643,921338,0
1692,834969,138467,93,1,Stable,Growth,597,138467,0
1693,3245398,719338,93,1,Stable,Stable,546,649079,70259
1694,3186651,670073,87,0,Low Volume,Declining,480,637330,32743
1695,1547827,336733,98,0,High Volume,Growth,678,336733,0
1696,2573832,497327,85,0,High Volume,Growth,662,497327,0
1697,728767,240136,94,0,Stable,Stable,592,145753,94383
1698,4152502,514572,91,0,Stable,Stable,574,514572,0
1699,1710127,736537,83,0,High Volume,Declining,556,342025,394512
1700,1305141,542392,95,0,Stable,Growth,641,391542,150850
1701,4589159,1213454,98,0,High Volume,Stable,649,1213454,0
1702,1128641,489524,98,0,High Volume,Growth,699,338592,150932
1703,642570,103592,93,1,Low Volume,Declining,465,103592,0
1704,570744,33049,93,0,Stable,Growth,636,33049,0
1705,3219730,1058144,86,0,High Volume,Stable,625,965919,92225
1706,711874,182282,94,0,Unstable,Stable,520,142374,39908
1707,8071383,2463580,90,0,High Volume,Growth,656,2421414,42166
1708,500000,227351,95,0,Stable,Growth,655,150000,77351
1709,7703344,3747419,95,0,Unstable,Stable,533,1540668,2206751
1710,2347388,787558,95,0,High Volume,Growth,688,704216,83342
1711,1835137,722723,95,0,Unstable,Growth,576,367027,355696
1712,1282170,112464,87,0,Low Volume,Declining,468,112464,0
1713,2728626,333771,87,0,Stable,Growth,610,333771,0
1714,1923953,730991,97,0,Stable,Growth,643,577185,153806
1715,4792877,1170011,85,0,Stable,Stable,546,958575,211436
1716,2172485,544608,95,0,Low Volume,Declining,525,434497,110111
1717,2236095,422339,88,1,High Volume,Growth,631,422339,0
1718,1482307,479245,93,0,Low Volume,Stable,551,296461,182784
1719,1894458,252577,97,0,Unstable,Growth,581,252577,0
1720,2536362,842357,98,0,Stable,Declining,548,507272,335085
1721,504774,64717,98,0,High Volume,Stable,656,64717,0
1722,674314,53083,92,0,High Volume,Growth,659,53083,0
1723,3593407,713870,95,0,Stable,Growth,623,713870,0
1724,2273185,350100,95,0,High Volume,Growth,705,350100,0
1725,1711385,770202,99,0,High Volume,Stable,647,513415,256787
1726,2012216,150371,92,0,Stable,Growth,606,150371,0
1727,2618377,339017,93,1,Stable,Growth,593,339017,0
1728,1287473,382281,96,0,Unstable,Growth,589,257494,124787
1729,1063798,283481,94,0,Stable,Declining,528,212759,70722
1730,2319069,163804,92,0,High Volume,Declining,569,163804,0
1731,906460,48281,93,0,High Volume,Growth,679,48281,0
1732,2748600,1359542,86,0,Stable,Stable,540,549720,809822
1733,507846,175956,95,1,Stable,Stable,560,101569,74387
1734,4516846,968560,91,0,Low Volume,Stable,523,903369,65191
1735,2893791,757289,84,2,Stable,Growth,518,578758,178531
1736,2433458,413560,96,1,Unstable,Growth,539,413560,0
1737,4352029,893007,85,0,High Volume,Growth,673,893007,0
1738,7514759,2570574,88,1,High Volume,Growth,634,2254427,316147
1739,4463733,1996473,98,1,Low Volume,Growth,564,892746,1103727
1740,500000,66429,93,1,Stable,Growth,572,66429,0
1741,712360,305006,95,0,Stable,Growth,651,213708,91298
1742,1202779,125932,97,0,High Volume,Stable,639,125932,0
1743,2024580,297100,98,0,High Volume,Growth,704,297100,0
1744,3000013,200188,91,1,High Volume,Stable,589,200188,0
1745,1109483,125777,94,1,Stable,Growth,589,125777,0
1746,2302287,1065467,93,0,Stable,Growth,647,690686,374781
1747,1083485,278182,97,0,Stable,Growth,634,278182,0
1748,1215645,103269,91,0,Low Volume,Stable,527,103269,0
1749,643496,310086,93,0,High Volume,Growth,681,193048,117038
1750,947340,422084,96,2,Stable,Stable,524,189468,232616
1751,672429,261983,92,0,High Volume,Growth,681,201728,60255
1752,908274,426946,89,1,Stable,Declining,467,181654,245292
1753,4606198,686592,91,2,Low Volume,Growth,519,686592,0
1754,927716,395547,93,1,Low Volume,Growth,558,185543,210004
1755,16287454,5871563,94,1,High Volume,Stable,585,3257490,2614073
1756,2942159,1298644,96,2,Stable,Stable,526,588431,710213
1757,2298734,939286,88,0,Unstable,Growth,572,459746,479540
1758,997806,205471,93,0,Low Volume,Growth,615,205471,0
1759,3472023,1383529,97,0,High Volume,Stable,660,1041606,341923
1760,1251045,210307,96,1,Stable,Stable,555,210307,0
1761,2186052,432546,81,1,High Volume,Stable,573,432546,0
1762,15372144,1515041,93,1,Stable,Stable,523,1515041,0
1763,1836096,864405,87,0,Stable,Stable,573,367219,497186
1764,4972427,899768,88,0,High Volume,Growth,674,899768,0
1765,1129696,321150,89,0,Stable,Stable,572,225939,95211
1766,1928030,435927,92,0,Low Volume,Growth,582,385606,50321
1767,8175402,3940279,99,0,High Volume,Stable,660,2452620,1487659
1768,1200713,241070,93,0,Low Volume,Growth,581,240142,928
1769,8452382,3383874,92,0,Stable,Growth,629,2535714,848160
1770,3492756,1519130,83,0,Low Volume,Declining,455,698551,820579
1771,1264297,311046,90,1,High Volume,Stable,587,252859,58187
1772,3288448,724042,97,0,High Volume,Stable,652,724042,0
1773,4316880,1668412,86,1,High Volume,Growth,604,1295064,373348
1774,3260685,1502534,89,1,Low Volume,Growth,535,652137,850397
1775,564570,220024,84,0,Stable,Stable,546,112914,107110
1776,1108247,168683,86,0,Stable,Stable,546,168683,0
1777,1626572,731532,91,0,High Volume,Growth,686,487971,243561
1778,1868139,419232,89,0,High Volume,Stable,633,419232,0
1779,3257719,1007623,98,1,Stable,Growth,587,651543,356080
1780,2285650,969449,80,0,High Volume,Declining,557,457130,512319
1781,681277,91821,97,1,Unstable,Declining,434,91821,0
1782,2687598,1083181,85,0,Stable,Growth,602,806279,276902
1783,3231538,1028512,96,1,High Volume,Growth,668,969461,59051
1784,3102852,1402501,91,0,High Volume,Growth,656,930855,471646
1785,4707298,599647,90,0,High Volume,Growth,652,599647,0
1786,3863707,924612,87,1,Stable,Stable,519,772741,151871
1787,2862895,1216099,98,1,High Volume,Growth,660,858868,357231
1788,1874528,109949,96,1,Stable,Stable,557,109949,0
1789,525041,52762,94,0,Low Volume,Stable,544,52762,0
1790,2795984,1386121,96,2,High Volume,Stable,570,559196,826925
1791,2341144,412457,78,1,Low Volume,Growth,497,412457,0
1792,2463917,1204842,98,0,Stable,Stable,608,739175,465667
1793,713974,94344,98,0,Unstable,Growth,582,94344,0
1794,834973,177425,91,1,Stable,Stable,551,166994,10431
1795,4604397,1790149,87,0,High Volume,Declining,572,920879,869270
1796,1920999,664666,87,0,Unstable,Stable,485,384199,280467
1797,3420169,1065400,99,0,High Volume,Declining,593,684033,381367
1798,2028191,585041,85,1,Stable,Growth,579,405638,179403
1799,2030525,872208,92,0,Unstable,Stable,512,406105,466103
1800,4200134,654074,82,1,High Volume,Growth,602,654074,0
1801,1312132,326868,98,1,Stable,Growth,608,326868,0
1802,2141242,256850,82,0,Unstable,Growth,556,256850,0
1803,1369806,435836,97,0,Stable,Growth,628,410941,24895
1804,1400588,227939,86,0,Stable,Stable,565,227939,0
1805,1548291,310013,94,0,Stable,Stable,580,309658,355
1806,2368357,620658,92,1,Stable,Growth,573,473671,146987
1807,1351872,83879,88,1,Unstable,Stable,452,83879,0
1808,5414575,494741,94,1,Stable,Growth,589,494741,0
1809,969285,347652,93,0,Stable,Growth,611,290785,56867
1810,1707435,414969,88,0,Low Volume,Growth,590,341487,73482
1811,1394735,612506,94,1,Stable,Stable,555,278947,333559
1812,6309597,2287875,84,0,Low Volume,Growth,567,1261919,1025956
1813,2320385,124478,88,0,High Volume,Growth,673,124478,0
1814,4526573,1482546,94,0,Stable,Growth,647,1357971,124575
1815,604134,55687,97,0,Stable,Stable,580,55687,0
1816,2455007,985489,96,0,High Volume,Growth,703,982002,3487
1817,4039796,2004460,94,0,Unstable,Stable,524,807959,1196501
1818,2117670,612090,97,2,Low Volume,Growth,539,423534,188556
1819,4650030,1661227,99,0,High Volume,Stable,657,1395009,266218
1820,1310828,205527,90,0,Stable,Growth,639,205527,0
1821,6122481,1511757,94,1,Stable,Declining,502,1224496,287261
1822,12473519,5429011,92,0,Stable,Stable,572,2494703,2934308
1823,1483225,185908,91,0,Low Volume,Declining,477,185908,0
1824,1388310,235306,96,0,High Volume,Growth,701,235306,0
1825,6342018,1588328,98,0,Low Volume,Stable,568,1268403,319925
1826,7015677,2599393,93,0,Stable,Stable,582,1403135,1196258
1827,1304998,285987,90,1,Stable,Stable,522,260999,24988
1828,1416714,662285,89,0,High Volume,Growth,657,425014,237271
1829,1582588,146398,93,0,Unstable,Growth,588,146398,0
1830,676332,146671,98,1,Stable,Growth,601,146671,0
1831,950818,350880,86,0,High Volume,Growth,668,285245,65635
1832,887965,134699,89,0,High Volume,Growth,648,134699,0
1833,1072778,370522,88,1,Stable,Growth,575,214555,155967
1834,1928498,238936,97,0,High Volume,Growth,684,238936,0
1835,2391358,179809,92,0,Stable,Stable,569,179809,0
1836,6854394,715990,97,0,Unstable,Stable,521,715990,0
1837,892085,417936,95,0,Stable,Growth,650,267625,150311
1838,4357713,1299853,93,0,High Volume,Stable,617,1299853,0
1839,1670793,682278,93,0,High Volume,Stable,612,501237,181041
1840,1905832,380584,89,0,High Volume,Growth,678,380584,0
1841,3401937,1077381,80,0,Low Volume,Stable,527,680387,396994
1842,807600,220256,90,0,High Volume,Growth,663,220256,0
1843,2692358,1280437,97,1,High Volume,Growth,660,807707,472730
1844,2265173,875282,86,0,Unstable,Stable,510,453034,422248
1845,2940120,1113553,94,1,Stable,Growth,585,588024,525529
1846,2498834,177065,96,0,Stable,Stable,598,177065,0
1847,14136068,4203379,89,0,Unstable,Stable,517,2827213,1376166
1848,1190410,309681,91,0,Stable,Declining,517,238082,71599
1849,1296531,606166,96,0,High Volume,Declining,568,259306,346860
1850,1204395,199693,91,0,Low Volume,Declining,480,199693,0
1851,1271386,217947,94,0,High Volume,Declining,586,217947,0
1852,1190746,279951,91,1,Stable,Growth,588,238149,41802
1853,5133064,818808,95,0,Low Volume,Declining,508,818808,0
1854,6177371,667976,97,2,Unstable,Growth,515,667976,0
1855,1255950,547389,96,1,Stable,Declining,496,251190,296199
1856,1018779,306881,81,0,Stable,Stable,534,203755,103126
1857,2891056,1265164,83,0,High Volume,Declining,541,578211,686953
1858,1274700,540486,95,0,Stable,Declining,530,254940,285546
1859,3289827,582033,95,0,Stable,Declining,543,582033,0
1860,2332237,691466,96,0,Stable,Declining,527,466447,225019
1861,589721,51570,95,0,Low Volume,Growth,616,51570,0
1862,6837988,3158216,94,1,Stable,Declining,489,1367597,1790619
1863,8341071,1934446,94,1,High Volume,Growth,632,1934446,0
1864,1214410,275858,89,0,Stable,Stable,553,242882,32976
1865,1454014,270795,87,1,High Volume,Stable,574,270795,0
1866,2492240,641250,93,1,High Volume,Stable,580,498448,142802
1867,2591028,423093,91,0,High Volume,Stable,618,423093,0
1868,3357930,734324,88,0,Unstable,Growth,544,671586,62738
1869,9901171,4059244,90,0,Low Volume,Growth,599,1980234,2079010
1870,1721045,732158,92,1,Unstable,Stable,488,344209,387949
1871,1046919,195650,99,0,Stable,Stable,609,195650,0
1872,657727,171704,94,0,High Volume,Growth,666,171704,0
1873,1104890,489708,97,0,High Volume,Growth,687,331467,158241
1874,1930903,142313,93,0,High Volume,Growth,692,142313,0
1875,8332268,3750481,91,1,Low Volume,Declining,448,1666453,2084028
1876,1310489,194782,92,0,High Volume,Declining,564,194782,0
1877,2371493,842693,89,1,High Volume,Stable,588,474298,368395
1878,1956880,610837,91,0,Low Volume,Growth,608,587064,23773
1879,5130505,1533115,96,0,High Volume,Growth,694,1533115,0
1880,14969808,6537496,91,0,Stable,Declining,532,2993961,3543535
1881,1296663,124100,96,0,Stable,Declining,532,124100,0
1882,1340360,276332,95,0,Low Volume,Growth,611,276332,0
1883,4571394,1335824,85,0,Low Volume,Stable,526,914278,421546
1884,3421239,1420088,95,1,Stable,Declining,496,684247,735841
1885,8687240,1280494,93,0,Low Volume,Growth,602,1280494,0
1886,3163351,1301145,96,0,Low Volume,Stable,551,632670,668475
1887,1487439,341869,98,0,Low Volume,Declining,531,297487,44382
1888,3180420,429392,94,0,Unstable,Declining,457,429392,0
1889,4813634,1884749,97,0,High Volume,Growth,687,1444090,440659
1890,3822387,347472,79,1,High Volume,Declining,504,347472,0
1891,2975192,837949,91,0,Stable,Growth,626,837949,0
1892,4654475,366512,98,0,Stable,Growth,638,366512,0
1893,5052716,1063031,96,0,Low Volume,Growth,615,1063031,0
1894,5990750,1919943,93,1,High Volume,Growth,632,1797225,122718
1895,3331616,1000324,100,0,Stable,Stable,590,666323,334001
1896,1734631,402599,81,1,Stable,Growth,533,346926,55673
1897,2229685,541973,84,0,Stable,Declining,498,445937,96036
1898,5205400,791462,91,0,High Volume,Declining,577,791462,0
1899,1031425,263165,93,0,High Volume,Growth,660,263165,0
1900,2662933,1275451,90,0,High Volume,Stable,601,798879,476572
1901,1447472,626327,94,0,Stable,Stable,600,434241,192086
1902,2028883,234041,84,1,Stable,Stable,506,234041,0
1903,5513783,349581,88,0,High Volume,Growth,656,349581,0
1904,2310280,1086030,95,0,Low Volume,Growth,596,462056,623974
1905,2057803,590666,96,0,Low Volume,Stable,548,411560,179106
1906,668048,195088,90,1,High Volume,Stable,588,133609,61479
1907,3602011,1445570,91,0,Low Volume,Declining,483,720402,725168
1908,3323029,636726,97,0,High Volume,Growth,674,636726,0
1909,11190814,2986363,85,1,Low Volume,Growth,515,2238162,748201
1910,1550018,753151,89,0,Unstable,Declining,463,310003,443148
1911,2362711,832777,99,0,High Volume,Declining,611,708813,123964
1912,2420554,288494,99,0,Low Volume,Growth,609,288494,0
1913,7003794,770081,97,0,High Volume,Stable,651,770081,0
1914,1837219,260737,93,0,Unstable,Growth,559,260737,0
1915,2478632,979110,92,1,Stable,Growth,575,495726,483384
1916,3224593,589841,98,0,Stable,Growth,660,589841,0
1917,2301996,137256,89,0,Low Volume,Growth,574,137256,0
1918,1387277,658788,87,0,High Volume,Stable,606,416183,242605
1919,2315814,292652,91,0,Stable,Growth,607,292652,0
1920,4680453,254154,94,0,High Volume,Declining,582,254154,0
1921,872212,136684,94,0,Stable,Growth,619,136684,0
1922,2205304,343505,88,1,Low Volume,Growth,558,343505,0
1923,1132461,271680,93,1,Low Volume,Growth,543,226492,45188
1924,5157886,2394164,91,0,Stable,Stable,565,1031577,1362587
1925,586220,261239,85,0,Low Volume,Growth,567,117244,143995
1926,1267887,324075,98,1,High Volume,Stable,588,253577,70498
1927,2681185,629824,92,0,Low Volume,Stable,558,536237,93587
1928,6937272,2079476,97,0,High Volume,Stable,636,2079476,0
1929,1881161,300147,97,0,High Volume,Growth,690,300147,0
1930,1271669,93446,92,2,Stable,Declining,463,93446,0
1931,8929988,4220767,94,1,Stable,Stable,549,1785997,2434770
1932,622556,83432,91,0,Stable,Growth,618,83432,0
1933,500000,69640,95,0,Low Volume,Stable,566,69640,0
1934,2819335,740378,91,1,Stable,Growth,594,563867,176511
1935,1326901,359890,90,0,Stable,Growth,610,359890,0
1936,875906,51061,92,0,Stable,Growth,607,51061,0
1937,3494445,407381,94,1,Low Volume,Stable,495,407381,0
1938,2409767,530558,93,1,Stable,Declining,481,481953,48605
1939,1262667,451629,85,0,Low Volume,Declining,459,252533,199096
1940,711945,108777,96,0,High Volume,Stable,624,108777,0
1941,3984673,957742,90,1,Stable,Stable,522,796934,160808
1942,3335593,1003364,92,1,Stable,Stable,537,667118,336246
1943,1831525,823942,96,0,Stable,Growth,619,549457,274485
1944,8686751,1708960,93,0,Stable,Growth,648,1708960,0
1945,842334,92742,95,0,Stable,Declining,540,92742,0
1946,585124,158084,94,0,Stable,Growth,640,158084,0
1947,1139926,440040,91,1,Stable,Stable,520,227985,212055
1948,1911753,190099,91,0,Unstable,Growth,562,190099,0
1949,2408878,580799,93,0,High Volume,Stable,611,580799,0
1950,1634768,94822,92,0,Stable,Growth,646,94822,0
1951,2627765,171072,89,1,High Volume,Declining,512,171072,0
1952,728519,194754,91,0,Stable,Growth,603,194754,0
1953,6293398,1159173,95,0,High Volume,Stable,633,1159173,0
1954,1856640,798909,88,2,Stable,Growth,553,371328,427581
1955,4846836,1555686,97,1,Low Volume,Declining,462,969367,586319
1956,2608224,663193,98,0,High Volume,Stable,625,663193,0
1957,2857343,667392,89,2,Unstable,Growth,497,571468,95924
1958,3127717,856245,93,0,High Volume,Growth,694,856245,0
1959,2836742,193459,91,0,Low Volume,Stable,559,193459,0
1960,3315696,1497889,92,1,High Volume,Growth,655,994708,503181
1961,5742022,2866627,91,0,Stable,Declining,511,1148404,1718223
1962,2320323,305515,97,0,Stable,Stable,605,305515,0
1963,3496255,364213,96,0,Stable,Growth,658,364213,0
1964,1845409,211502,96,1,Stable,Declining,517,211502,0
1965,6275061,2180346,86,1,Low Volume,Declining,440,1255012,925334
1966,1154163,401243,96,2,Low Volume,Growth,515,230832,170411
1967,8374922,3614331,91,1,Unstable,Declining,417,1674984,1939347
1968,1920073,745606,99,0,High Volume,Growth,699,576021,169585
1969,631201,159290,89,2,High Volume,Stable,552,126240,33050
1970,2196737,715664,91,0,Unstable,Growth,579,439347,276317
1971,1149869,413640,96,0,High Volume,Declining,579,229973,183667
1972,3884539,1090512,86,0,High Volume,Growth,655,1090512,0
1973,1176319,310599,94,0,High Volume,Growth,687,310599,0
1974,1387554,472176,96,1,Stable,Stable,557,277510,194666
1975,500000,150432,88,0,Stable,Stable,571,100000,50432
1976,1380774,469151,90,0,High Volume,Stable,611,414232,54919
1977,500000,162892,98,0,High Volume,Stable,631,150000,12892
1978,558426,208649,90,1,Stable,Growth,592,111685,96964
1979,3643050,1235947,87,1,High Volume,Stable,564,728610,507337
1980,3717791,1055422,90,0,High Volume,Stable,600,1055422,0
1981,2786693,994316,88,1,Stable,Growth,554,557338,436978
1982,914762,230764,94,0,Stable,Stable,588,182952,47812
1983,1908505,302979,88,0,High Volume,Stable,627,302979,0
1984,1977053,100114,97,0,Stable,Stable,578,100114,0
1985,784897,237026,94,0,Unstable,Growth,561,156979,80047
1986,6600914,2084535,98,0,High Volume,Growth,693,1980274,104261
1987,4000340,1949854,86,0,High Volume,Growth,674,1200102,749752
1988,1661496,353342,89,0,Stable,Stable,547,332299,21043
1989,2025868,460601,94,0,High Volume,Stable,641,460601,0
1990,2342446,329839,85,0,Stable,Growth,609,329839,0
1991,500000,40870,99,0,Low Volume,Stable,576,40870,0
1992,1627016,647165,88,1,High Volume,Declining,529,325403,321762
1993,1149012,186550,90,1,Stable,Declining,477,186550,0
1994,889757,288288,91,1,Low Volume,Declining,442,177951,110337
1995,1583455,569249,88,2,Unstable,Declining,360,316691,252558
1996,8353150,2188997,97,0,Stable,Growth,630,2188997,0
1997,3310714,1471144,95,0,High Volume,Stable,620,993214,477930
1998,1255516,313512,90,0,Stable,Stable,553,251103,62409
1999,3134770,558644,92,0,Low Volume,Growth,615,558644,0
2000,6073735,2752659,95,0,Low Volume,Stable,544,1214747,1537912
2001,4154518,1818449,96,0,Unstable,Growth,583,830903,987546
2002,2079638,257497,91,0,Stable,Declining,543,257497,0
2003,1181683,72889,82,0,Stable,Declining,502,72889,0
2004,3466232,313671,91,0,Stable,Stable,584,313671,0
2005,2716319,486075,98,0,Stable,Stable,579,486075,0
2006,4057812,1978252,92,0,High Volume,Growth,684,1217343,760909
2007,3295727,993109,90,0,Low Volume,Stable,558,659145,333964
2008,4591155,1000724,90,1,High Volume,Declining,532,918231,82493
2009,1292142,581363,91,0,High Volume,Growth,683,387642,193721
2010,5688262,1444314,94,0,Stable,Growth,647,1444314,0
2011,2322326,445555,94,1,Unstable,Growth,548,445555,0
2012,10430124,4939173,83,0,Stable,Growth,583,2086024,2853149
2013,1142409,493844,88,0,High Volume,Declining,548,228481,265363
2014,7950704,3416026,87,0,Low Volume,Stable,516,1590140,1825886
2015,2322904,651640,88,0,Stable,Stable,563,464580,187060
2016,1177455,477160,97,0,Stable,Growth,626,353236,123924
2017,1346328,175977,96,1,Low Volume,Stable,525,175977,0
2018,1534511,472553,94,0,Stable,Growth,623,460353,12200
2019,2783815,1371671,93,0,Low Volume,Stable,561,556763,814908
2020,3012462,545049,84,0,High Volume,Declining,545,545049,0
2021,1252986,510540,88,0,High Volume,Stable,625,375895,134645
2022,1944502,526406,96,0,Stable,Stable,603,526406,0
2023,11004516,747345,89,0,Stable,Stable,568,747345,0
2024,7897324,3106481,83,0,Stable,Stable,558,1579464,1527017
2025,2811023,353784,89,0,Low Volume,Declining,467,353784,0
2026,2043966,683018,87,0,Unstable,Growth,542,408793,274225
2027,2182595,193266,89,0,Low Volume,Growth,572,193266,0
2028,3239127,1542117,87,0,Stable,Declining,504,647825,894292
2029,874813,158582,88,1,Low Volume,Growth,540,158582,0
2030,1613794,245150,91,0,Stable,Growth,634,245150,0
2031,521849,56418,92,0,Unstable,Growth,580,56418,0
2032,2728816,1298100,96,0,Low Volume,Growth,611,818644,479456
2033,3327583,1232393,92,0,High Volume,Declining,594,665516,566877
2034,1347081,516939,94,3,High Volume,Stable,494,269416,247523
2035,6984398,1918838,98,0,Stable,Declining,539,1396879,521959
2036,743696,196059,95,0,Stable,Declining,538,148739,47320
2037,614461,61145,92,1,High Volume,Declining,531,61145,0
2038,2372753,716402,95,0,Low Volume,Declining,494,474550,241852
2039,4582149,738241,93,0,Stable,Stable,576,738241,0
2040,7626520,3734824,93,0,High Volume,Growth,670,2287956,1446868
2041,1373527,561033,91,0,High Volume,Stable,624,412058,148975
2042,4699397,1108336,87,0,Stable,Declining,531,939879,168457
2043,1922608,227067,93,0,Stable,Declining,547,227067,0
2044,1727003,696672,99,0,High Volume,Stable,663,518100,178572
2045,4020545,421852,96,0,Stable,Stable,586,421852,0
2046,3341259,451739,88,0,High Volume,Growth,662,451739,0
2047,561792,81563,86,1,Unstable,Growth,489,81563,0
2048,6460597,1942061,86,1,Stable,Stable,519,1292119,649942
2049,5980849,2417313,87,0,Unstable,Growth,570,1196169,1221144
2050,1202063,230125,88,0,Low Volume,Growth,578,230125,0
2051,2721361,239756,95,0,Stable,Growth,618,239756,0
2052,2943836,762578,86,0,Stable,Declining,501,588767,173811
2053,2442516,944398,80,0,Stable,Declining,496,488503,455895
2054,1276657,191178,89,0,Unstable,Growth,556,191178,0
2055,1158575,172588,91,0,Stable,Growth,638,172588,0
2056,1942637,925185,93,0,Stable,Growth,613,582791,342394
2057,5066614,2428779,97,1,Stable,Stable,569,1013322,1415457
2058,3062923,1518320,98,0,High Volume,Stable,649,918876,599444
2059,1474027,609432,88,0,Stable,Stable,568,294805,314627
2060,3676085,495106,91,0,Low Volume,Declining,480,495106,0
2061,500000,72696,86,0,High Volume,Stable,620,72696,0
2062,4970408,1009497,80,0,Stable,Growth,609,1009497,0
2063,500000,96580,93,0,Stable,Stable,591,96580,0
2064,1483697,712824,89,0,Unstable,Declining,466,296739,416085
2065,809575,327945,89,0,Unstable,Growth,548,161915,166030
2066,703804,264492,91,0,Low Volume,Growth,587,140760,123732
2067,5018599,670904,91,1,Stable,Growth,599,670904,0
2068,1363873,626408,96,1,Low Volume,Stable,522,272774,353634
2069,2616121,1105420,85,0,Stable,Growth,620,784836,320584
2070,1909713,236115,85,0,Stable,Growth,622,236115,0
2071,2904096,1283688,83,1,High Volume,Stable,539,580819,702869
2072,2108437,363729,95,1,Unstable,Growth,552,363729,0
2073,710416,61374,96,0,Stable,Stable,574,61374,0
2074,4399553,1520354,95,0,Stable,Declining,529,879910,640444
2075,1335738,459777,87,0,High Volume,Declining,579,267147,192630
2076,570766,52921,83,0,Stable,Growth,610,52921,0
2077,1407757,272377,88,0,Unstable,Growth,541,272377,0
2078,6586995,3272199,90,0,Low Volume,Stable,549,1317399,1954800
2079,3914419,1390762,80,0,Low Volume,Declining,459,782883,607879
2080,1500154,567859,90,1,Stable,Growth,588,300030,267829
2081,1499427,218636,97,0,High Volume,Stable,622,218636,0
2082,1532931,130992,84,0,Stable,Growth,596,130992,0
2083,10442540,1823328,99,0,Stable,Growth,656,1823328,0
2084,2691336,436008,94,0,Stable,Growth,617,436008,0
2085,2796931,435048,92,0,Stable,Stable,578,435048,0
2086,4520923,618189,96,0,High Volume,Stable,637,618189,0
2087,2400125,740775,96,0,Unstable,Declining,484,480025,260750
2088,1611646,318536,95,2,Unstable,Stable,428,318536,0
2089,1694537,710274,97,1,High Volume,Stable,607,508361,201913
2090,1872376,248607,86,1,Stable,Growth,552,248607,0
2091,1924587,498626,85,1,Stable,Growth,561,384917,113709
2092,3548742,199248,91,1,High Volume,Growth,633,199248,0
2093,2066892,551358,86,0,Low Volume,Growth,592,413378,137980
2094,3562995,267678,96,0,High Volume,Growth,702,267678,0
2095,1858772,910753,91,0,Stable,Declining,537,371754,538999
2096,2111498,856775,93,0,Stable,Growth,628,633449,223326
2097,500000,135275,95,0,Low Volume,Stable,569,100000,35275
2098,4127003,367156,97,0,Stable,Growth,652,367156,0
2099,2616088,828255,93,0,Low Volume,Stable,536,523217,305038
2100,4405693,1724581,92,0,Stable,Growth,631,1321707,402874
2101,500000,67911,93,0,High Volume,Growth,659,67911,0
2102,10540123,3222050,97,2,High Volume,Growth,615,3162036,60014
2103,1773257,738375,94,0,Low Volume,Growth,586,354651,383724
2104,4811629,1904017,79,0,Stable,Stable,542,962325,941692
2105,862918,354958,96,1,Stable,Growth,613,258875,96083
2106,3237199,1442805,86,0,Stable,Growth,594,647439,795366
2107,853642,402882,98,0,High Volume,Declining,613,256092,146790
2108,1203789,279862,91,2,Low Volume,Declining,419,240757,39105
2109,9167958,2804901,91,1,Stable,Growth,570,1833591,971310
2110,1702237,690762,92,0,Stable,Declining,527,340447,350315
2111,2359467,858169,97,0,Stable,Declining,528,471893,386276
2112,3977063,1980514,93,0,High Volume,Stable,634,1193118,787396
2113,2947729,165530,93,0,High Volume,Stable,641,165530,0
2114,2236304,469199,100,0,Stable,Stable,599,447260,21939
2115,2655036,468514,96,0,High Volume,Stable,625,468514,0
2116,13561324,2278874,86,0,Stable,Declining,489,2278874,0
2117,1893438,284278,94,1,High Volume,Stable,596,284278,0
2118,2328836,859587,92,1,Low Volume,Stable,489,465767,393820
2119,4595203,405029,91,0,High Volume,Growth,655,405029,0
2120,4801413,1842417,96,0,Low Volume,Stable,578,960282,882135
2121,5124914,1855432,95,0,High Volume,Growth,684,1537474,317958
2122,3305123,538278,83,0,Low Volume,Stable,516,538278,0
2123,794602,130136,84,0,Stable,Stable,556,130136,0
2124,7324572,2438989,85,0,Stable,Declining,492,1464914,974075
2125,792481,311427,94,0,High Volume,Growth,700,311427,0
2126,2525901,1122557,95,0,High Volume,Growth,678,757770,364787
2127,1084445,470067,95,0,Stable,Growth,621,325333,144734
2128,1883589,912029,89,1,Stable,Growth,564,376717,535312
2129,2579252,803755,96,1,Stable,Stable,564,515850,287905
2130,2564017,1176615,87,1,High Volume,Growth,608,769205,407410
2131,2778819,1149961,84,1,Stable,Growth,582,555763,594198
2132,7209924,3263215,90,2,Stable,Growth,539,1441984,1821231
2133,2849994,157411,91,0,High Volume,Growth,684,157411,0
2134,1630952,790451,93,0,Unstable,Declining,474,326190,464261
2135,4287737,1128055,93,0,Low Volume,Growth,616,1128055,0
2136,5134928,2101122,88,0,Stable,Growth,608,1540478,560644
2137,742601,79638,93,0,Stable,Growth,640,79638,0
2138,3197629,729614,94,0,Stable,Growth,621,729614,0
2139,3474420,598147,93,0,High Volume,Growth,670,598147,0
2140,1562737,283241,89,0,Stable,Declining,523,283241,0
2141,5959907,628562,90,0,High Volume,Declining,562,628562,0
2142,1758472,725535,97,0,Stable,Declining,530,351694,373841
2143,2192299,118733,81,0,Unstable,Growth,526,118733,0
2144,1726389,329097,93,0,Stable,Stable,571,329097,0
2145,2007625,257949,90,0,High Volume,Growth,669,257949,0
2146,824869,259889,84,0,Stable,Growth,605,247460,12429
2147,626535,103011,88,0,Unstable,Stable,499,103011,0
2148,7099991,1182499,91,0,High Volume,Growth,678,1182499,0
2149,1006944,271625,95,2,Stable,Growth,539,201388,70237
2150,897067,308331,88,0,Low Volume,Growth,593,179413,128918
2151,500000,52294,96,0,Low Volume,Growth,609,52294,0
2152,1189247,153389,85,0,Low Volume,Growth,593,153389,0
2153,687989,110924,82,1,Unstable,Stable,455,110924,0
2154,7375042,3600397,84,1,High Volume,Stable,566,1475008,2125389
2155,4447504,1017227,99,1,High Volume,Declining,554,889500,127727
2156,1143358,365355,85,0,High Volume,Growth,670,343007,22348
2157,12018391,1907250,89,0,High Volume,Stable,605,1907250,0
2158,4348808,1177252,88,0,High Volume,Growth,661,1177252,0
2159,1529016,127449,93,0,Low Volume,Growth,601,127449,0
2160,500000,32817,92,2,Low Volume,Stable,457,32817,0
2161,12394384,3234068,88,0,Stable,Growth,604,3234068,0
2162,652354,149648,80,0,Unstable,Growth,510,130470,19178
2163,531618,59327,97,1,Stable,Declining,481,59327,0
2164,4493113,1614918,96,0,High Volume,Growth,672,1347933,266985
2165,13961330,6936080,96,0,Stable,Stable,594,2792266,4143814
2166,6000889,1368449,86,0,Stable,Stable,544,1200177,168272
2167,3113093,1030594,85,0,High Volume,Stable,602,933927,96667
2168,3190868,1542272,96,0,Unstable,Growth,576,638173,904099
2169,3924433,1664708,88,1,Stable,Growth,591,784886,879822
2170,3638721,940968,86,0,Stable,Stable,541,727744,213224
2171,2482938,948160,87,1,Unstable,Declining,420,496587,451573
2172,2155128,232023,95,0,Low Volume,Stable,575,232023,0
2173,1885918,528900,90,0,Stable,Stable,554,377183,151717
2174,1084716,190451,86,1,High Volume,Growth,636,190451,0
2175,1583994,194077,90,0,High Volume,Stable,640,194077,0
2176,511772,123760,94,0,Stable,Growth,630,123760,0
2177,1832750,199690,91,1,Unstable,Growth,506,199690,0
2178,899080,327754,92,0,Low Volume,Stable,530,179816,147938
2179,820057,209367,94,0,High Volume,Stable,629,209367,0
2180,2289663,661747,97,0,Unstable,Growth,601,661747,0
2181,6038111,699631,93,0,High Volume,Stable,645,699631,0
2182,4133575,466669,86,0,Low Volume,Stable,535,466669,0
2183,564446,176410,90,1,High Volume,Growth,626,169333,7077
2184,898334,443107,93,0,High Volume,Declining,574,179666,263441
2185,4208500,392707,84,0,Stable,Stable,548,392707,0
2186,903481,161343,88,0,Low Volume,Declining,490,161343,0
2187,1656626,730997,94,1,Stable,Growth,598,331325,399672
2188,3078773,254068,98,0,Low Volume,Growth,594,254068,0
2189,913761,405846,89,0,Unstable,Stable,513,182752,223094
2190,2157154,616792,98,0,High Volume,Stable,658,616792,0
2191,681996,159396,90,0,Low Volume,Growth,606,159396,0
2192,1225557,232067,99,0,High Volume,Stable,660,232067,0
2193,2560788,470424,91,0,Stable,Declining,503,470424,0
2194,554380,104008,98,0,Low Volume,Growth,620,104008,0
2195,2820373,1263982,94,1,Stable,Growth,595,564074,699908
2196,1951853,733327,88,0,Unstable,Stable,504,390370,342957
2197,3084783,1083917,97,0,Stable,Declining,560,616956,466961
2198,2371733,971076,94,0,Stable,Stable,579,474346,496730
2199,5905014,978470,93,0,Unstable,Stable,503,978470,0
2200,2191681,719133,95,0,Stable,Growth,655,657504,61629
2201,1406304,361462,92,0,Low Volume,Growth,593,281260,80202
2202,2186555,879211,94,0,Stable,Declining,518,437311,441900
2203,3062182,579258,95,0,High Volume,Declining,582,579258,0
2204,2061796,699836,86,1,Stable,Declining,472,412359,287477
2205,2048203,915538,96,0,High Volume,Growth,699,614460,301078
2206,1130767,261171,87,0,Low Volume,Growth,561,226153,35018
2207,1166688,93312,84,0,Stable,Declining,491,93312,0
2208,645587,182199,93,1,High Volume,Declining,550,129117,53082
2209,8037763,1653268,77,0,Low Volume,Stable,489,1607552,45716
2210,733006,258386,99,0,Low Volume,Stable,566,146601,111785
2211,1139017,544410,88,1,Low Volume,Stable,498,227803,316607
2212,1116014,299676,89,1,Stable,Growth,584,223202,76474
2213,4056940,1053935,94,1,Low Volume,Stable,507,811388,242547
2214,1566008,539589,91,0,Stable,Growth,630,469802,69787
2215,5379972,519565,92,0,Stable,Growth,625,519565,0
2216,1156846,189813,97,0,Stable,Stable,597,189813,0
2217,2478577,1148921,81,1,Stable,Declining,458,495715,653206
2218,1016344,357219,94,0,Low Volume,Stable,557,203268,153951
2219,11029889,618223,88,0,Unstable,Growth,559,618223,0
2220,766754,108942,95,0,Low Volume,Stable,556,108942,0
2221,2540462,907648,98,1,Stable,Growth,621,762138,145510
2222,3292052,1297001,97,2,Stable,Stable,497,658410,638591
2223,2760823,1181458,89,0,High Volume,Stable,600,828246,353212
2224,1709600,310257,83,1,High Volume,Growth,624,310257,0
2225,1787169,838116,92,0,High Volume,Growth,679,536150,301966
2226,2053486,613635,84,0,Unstable,Stable,510,410697,202938
2227,1762772,640666,92,0,Low Volume,Growth,605,528831,111835
2228,4287024,1365556,86,0,High Volume,Stable,624,1286107,79449
2229,11622093,1223028,83,0,Stable,Stable,565,1223028,0
2230,1269339,613600,89,2,High Volume,Stable,525,253867,359733
2231,662753,69784,88,0,High Volume,Declining,566,69784,0
2232,1847556,304287,83,0,Stable,Growth,607,304287,0
2233,15615389,6498072,85,0,Stable,Stable,539,3123077,3374995
2234,1042425,342300,95,1,Low Volume,Growth,577,208485,133815
2235,7357961,3143079,92,2,High Volume,Stable,565,1471592,1671487
2236,7588623,2140609,91,0,Stable,Growth,637,2140609,0
2237,1273309,279678,93,0,Stable,Declining,521,254661,25017
2238,3125755,1452946,84,0,Unstable,Growth,544,625151,827795
2239,7295128,483766,96,1,Stable,Growth,603,483766,0
2240,1464022,637228,95,0,Stable,Growth,648,439206,198022
2241,1684763,259231,97,1,High Volume,Stable,618,259231,0
2242,1245011,537759,84,0,High Volume,Growth,658,373503,164256
2243,880455,99173,92,0,Unstable,Growth,583,99173,0
2244,1179473,366932,96,0,Stable,Stable,576,235894,131038
2245,744783,334891,95,1,Stable,Growth,591,148956,185935
2246,2037567,536069,95,0,Low Volume,Growth,623,536069,0
2247,1070912,413324,86,0,High Volume,Growth,659,321273,92051
2248,2390537,985146,100,0,Stable,Growth,643,717161,267985
2249,571079,217822,98,1,High Volume,Growth,645,171323,46499
2250,2583625,1204999,94,0,Low Volume,Stable,548,516725,688274
2251,3862492,969777,93,0,Unstable,Stable,511,772498,197279
2252,500000,63953,94,0,Low Volume,Growth,607,63953,0
2253,2674426,191262,85,0,High Volume,Stable,610,191262,0
2254,5294268,851884,88,0,Low Volume,Growth,596,851884,0
2255,753351,86213,92,0,Stable,Declining,528,86213,0
2256,7557552,2275405,99,1,Unstable,Declining,449,1511510,763895
2257,2772376,369351,90,0,High Volume,Growth,676,369351,0
2258,1128038,76165,96,0,High Volume,Growth,682,76165,0
2259,1896242,125523,98,0,Low Volume,Stable,557,125523,0
2260,3099222,1314709,99,1,High Volume,Growth,639,929766,384943
2261,2107060,666152,99,0,Stable,Growth,654,632118,34034
2262,3051076,644199,99,1,Stable,Stable,563,610215,33984
2263,949282,429458,94,1,Low Volume,Stable,532,189856,239602
2264,2270450,185243,93,0,Low Volume,Growth,618,185243,0
2265,639875,314271,99,0,Low Volume,Declining,501,127975,186296
2266,1813953,593764,89,0,High Volume,Stable,598,362790,230974
2267,962100,127535,96,0,Low Volume,Stable,576,127535,0
2268,1100831,391435,86,0,Stable,Stable,548,220166,171269
2269,5330068,2097497,81,0,High Volume,Declining,546,1066013,1031484
2270,4747117,1154519,90,0,High Volume,Growth,680,1154519,0
2271,3227797,1412919,95,0,Unstable,Declining,471,645559,767360
2272,827488,97503,89,1,High Volume,Growth,627,97503,0
2273,1539354,270121,89,0,Low Volume,Stable,553,270121,0
2274,5232910,481802,94,0,Unstable,Stable,507,481802,0
2275,2220790,321781,97,0,High Volume,Growth,686,321781,0
2276,12679076,1996041,89,0,Low Volume,Growth,598,1996041,0
2277,2715955,1257310,97,0,High Volume,Stable,660,814786,442524
2278,2312036,196868,95,0,High Volume,Declining,570,196868,0
2279,1548360,375225,92,0,Stable,Growth,627,375225,0
2280,2206312,638903,94,0,Stable,Growth,622,638903,0
2281,1755078,797528,89,1,High Volume,Growth,643,526523,271005
2282,3493753,1743255,91,0,Stable,Stable,560,698750,1044505
2283,4262481,1658210,99,0,Stable,Declining,565,852496,805714
2284,1057278,514742,93,0,High Volume,Growth,666,317183,197559
2285,683522,276277,92,1,Stable,Growth,583,136704,139573
2286,500000,241721,90,0,Stable,Stable,572,100000,141721
2287,2976900,1096308,88,1,High Volume,Growth,610,893070,203238
2288,820203,70450,87,0,Low Volume,Growth,597,70450,0
2289,500000,115432,80,0,High Volume,Stable,607,115432,0
2290,2705677,922551,90,1,Stable,Stable,534,541135,381416
2291,14568899,3027757,97,0,Stable,Declining,549,2913779,113978
2292,1973153,341400,86,0,Stable,Declining,502,341400,0
2293,3877855,1201475,97,0,Low Volume,Growth,629,1163356,38119
2294,2116900,995104,95,0,Stable,Growth,654,635070,360034
2295,1831944,120435,80,0,High Volume,Declining,522,120435,0
2296,4136089,1638528,78,0,Low Volume,Growth,552,827217,811311
2297,1571876,589811,82,0,Stable,Growth,590,314375,275436
2298,2455679,1188006,96,0,Stable,Stable,602,736703,451303
2299,2564716,1202390,95,0,Stable,Growth,624,769414,432976
2300,1161854,456614,87,0,High Volume,Stable,604,348556,108058
2301,4384709,1246064,97,0,Unstable,Declining,489,876941,369123
2302,1723784,244640,94,1,Stable,Growth,576,244640,0
2303,1083172,319921,92,0,Stable,Growth,624,319921,0
2304,3045598,1201209,96,0,High Volume,Growth,698,913679,287530
2305,966296,437782,85,0,Low Volume,Declining,482,193259,244523
2306,2027968,822078,92,1,Unstable,Stable,467,405593,416485
2307,1968347,271376,79,0,Low Volume,Growth,574,271376,0
2308,4726599,1511844,93,0,High Volume,Growth,694,1417979,93865
2309,2898658,578219,93,0,Low Volume,Growth,597,578219,0
2310,1943456,105224,83,0,High Volume,Growth,658,105224,0
2311,3814091,534352,91,0,High Volume,Growth,660,534352,0
2312,6029448,608669,92,0,Stable,Growth,636,608669,0
2313,3097941,1329709,95,0,Stable,Growth,647,929382,400327
2314,1999249,332531,91,0,High Volume,Stable,604,332531,0
2315,694211,123649,93,1,Stable,Growth,577,123649,0
2316,845691,407599,85,1,Low Volume,Declining,452,169138,238461
2317,1553188,342616,90,0,High Volume,Stable,638,342616,0
2318,1217598,66132,79,0,Stable,Growth,568,66132,0
2319,1707299,303440,87,1,Stable,Growth,576,303440,0
2320,2074685,215113,89,0,Low Volume,Declining,500,215113,0
2321,3029034,291586,95,0,Low Volume,Growth,615,291586,0
2322,1874029,159047,98,0,Low Volume,Growth,615,159047,0
2323,2926159,927495,91,0,Stable,Growth,615,877847,49648
2324,2087713,282272,83,0,Stable,Stable,546,282272,0
2325,500000,106280,96,0,Stable,Stable,594,100000,6280
2326,935215,409538,80,0,Stable,Growth,577,187043,222495
2327,1766887,425735,92,0,Stable,Growth,643,425735,0
2328,753319,348079,86,0,Low Volume,Growth,558,150663,197416
2329,3204104,878156,93,1,Stable,Growth,603,878156,0
2330,6746947,1548266,92,0,Unstable,Growth,559,1349389,198877
2331,5256676,2037882,94,0,High Volume,Growth,668,1577002,460880
2332,1671523,138617,98,0,Stable,Stable,575,138617,0
2333,6534333,589823,87,0,High Volume,Stable,597,589823,0
2334,2233173,766845,92,0,Stable,Stable,562,446634,320211
2335,1514099,407479,95,0,Low Volume,Stable,539,302819,104660
2336,1213814,492428,92,0,Low Volume,Growth,615,364144,128284
2337,1556615,719657,84,0,High Volume,Growth,639,466984,252673
2338,1453462,326688,92,0,Unstable,Growth,568,290692,35996
2339,2272368,723487,91,1,Low Volume,Stable,513,454473,269014
2340,2254546,620707,93,0,Unstable,Declining,467,450909,169798
2341,1987597,977351,91,0,Stable,Declining,530,397519,579832
2342,2812405,1192426,95,1,Stable,Growth,599,562481,629945
2343,5139760,2365739,90,0,High Volume,Growth,682,1541928,823811
2344,4238175,696981,94,1,Stable,Growth,609,696981,0
2345,604454,240353,88,0,High Volume,Stable,624,181336,59017
2346,500000,84731,90,0,Low Volume,Stable,526,84731,0
2347,4186836,602629,88,0,Stable,Declining,523,602629,0
2348,664305,315492,83,1,High Volume,Stable,556,132861,182631
2349,1656451,97212,95,0,Low Volume,Stable,546,97212,0
2350,777555,376667,96,1,High Volume,Growth,631,233266,143401
2351,500000,58584,95,0,Unstable,Stable,529,58584,0
2352,3057690,1280399,90,0,High Volume,Growth,674,917307,363092
2353,3639381,633853,92,0,Low Volume,Growth,589,633853,0
2354,1250172,259806,99,0,Stable,Growth,627,259806,0
2355,500000,73770,90,1,Low Volume,Declining,444,73770,0
2356,1280812,401511,97,0,Stable,Declining,556,256162,145349
2357,2712668,560554,93,2,Stable,Stable,492,542533,18021
2358,607356,210040,85,0,High Volume,Growth,673,182206,27834
2359,2296020,130968,90,1,Unstable,Stable,459,130968,0
2360,1958623,154670,92,0,Stable,Growth,616,154670,0
2361,3151639,298925,91,0,Low Volume,Growth,588,298925,0
2362,2181808,520464,82,0,Low Volume,Growth,547,436361,84103
2363,910314,379290,86,0,Stable,Declining,519,182062,197228
2364,5164182,2322230,88,0,Unstable,Stable,487,1032836,1289394
2365,1746591,279742,94,0,Stable,Growth,648,279742,0
2366,1939918,598399,97,0,Low Volume,Declining,510,387983,210416
2367,939765,371925,90,0,Low Volume,Growth,587,187953,183972
2368,1390778,250303,92,0,High Volume,Stable,614,250303,0
2369,976918,228651,95,1,Unstable,Stable,502,195383,33268
2370,1726563,493432,79,1,High Volume,Declining,494,345312,148120
2371,7797914,863180,84,0,Low Volume,Growth,590,863180,0
2372,661641,40818,95,0,Unstable,Declining,484,40818,0
2373,545332,64765,86,1,Low Volume,Growth,543,64765,0
2374,6432902,2136265,98,2,High Volume,Declining,523,1286580,849685
2375,1677040,139409,89,1,Stable,Growth,573,139409,0
2376,1160941,157149,99,0,Stable,Stable,590,157149,0
2377,4555855,920439,87,0,Stable,Declining,518,911171,9268
2378,1221399,103870,96,0,Stable,Growth,642,103870,0
2379,8544580,1164324,88,0,Low Volume,Stable,545,1164324,0
2380,3410402,1569028,91,0,Low Volume,Declining,484,682080,886948
2381,1341999,78755,93,0,High Volume,Declining,573,78755,0
2382,11137703,3831864,93,0,High Volume,Growth,664,3341310,490554
2383,1221302,272331,95,0,Stable,Growth,654,272331,0
2384,3590049,1266181,90,0,High Volume,Growth,651,1077014,189167
2385,2519155,793310,91,0,Stable,Stable,587,503831,289479
2386,5617476,845848,93,0,Stable,Stable,589,845848,0
2387,6915038,2982071,90,3,Stable,Stable,435,1383007,1599064
2388,2034180,552022,92,0,High Volume,Stable,611,552022,0
2389,1085190,455933,96,0,Stable,Growth,619,325557,130376
2390,2864710,666634,95,1,Stable,Growth,584,572942,93692
2391,1152942,568525,85,0,Low Volume,Stable,530,230588,337937
2392,9926414,3938009,84,0,Low Volume,Stable,538,1985282,1952727
2393,2211603,1071914,84,0,Stable,Growth,620,663480,408434
2394,1480281,416621,98,0,Stable,Stable,579,296056,120565
2395,2298447,604862,97,0,High Volume,Declining,590,459689,145173
2396,674886,263175,86,0,High Volume,Stable,608,202465,60710
2397,911374,406592,89,0,Low Volume,Stable,526,182274,224318
2398,5180080,2506463,93,0,Low Volume,Growth,602,1554024,952439
2399,1172307,229829,90,0,High Volume,Stable,614,229829,0
2400,858096,351319,92,0,Low Volume,Stable,559,171619,179700
2401,3045946,441024,90,1,Stable,Stable,547,441024,0
2402,5119479,1512849,89,0,Low Volume,Declining,478,1023895,488954
2403,3524195,461429,86,0,Stable,Stable,567,461429,0
2404,4398782,907595,93,0,High Volume,Growth,671,907595,0
2405,1082262,507701,93,1,Stable,Growth,596,216452,291249
2406,635744,73582,85,0,Stable,Stable,551,73582,0
2407,6590020,2204892,86,0,Low Volume,Growth,563,1318004,886888
2408,1531650,485272,92,1,Low Volume,Growth,537,306330,178942
2409,1622265,169255,81,1,Low Volume,Growth,516,169255,0
2410,5737622,1128536,92,0,Stable,Growth,629,1128536,0
2411,3094027,938547,91,0,Stable,Stable,553,618805,319742
2412,2855365,383277,93,0,High Volume,Growth,692,383277,0
2413,11206470,4597798,97,1,Unstable,Stable,477,2241294,2356504
2414,1184920,577613,94,0,High Volume,Stable,621,355476,222137
2415,4165189,610791,95,0,Low Volume,Stable,550,610791,0
2416,2075288,278318,92,0,High Volume,Stable,624,278318,0
2417,2458037,626113,90,2,High Volume,Stable,545,491607,134506
2418,6734639,2602900,88,0,Low Volume,Declining,499,1346927,1255973
2419,2976530,526013,88,0,Low Volume,Stable,553,526013,0
2420,3049953,179782,87,0,High Volume,Stable,628,179782,0
2421,4676244,1372708,89,0,Stable,Growth,630,1372708,0
2422,1480718,711441,80,1,High Volume,Growth,607,444215,267226
2423,1013208,229061,88,0,Unstable,Growth,549,202641,26420
2424,859540,205482,95,1,Stable,Growth,597,171908,33574
2425,500000,243003,94,0,High Volume,Growth,684,150000,93003
2426,10272343,3724479,87,1,High Volume,Stable,558,2054468,1670011
2427,820306,306489,94,0,High Volume,Stable,620,246091,60398
2428,1661111,503675,97,1,High Volume,Declining,556,332222,171453
2429,1588895,776293,84,2,Stable,Stable,460,317779,458514
2430,2535561,912776,96,0,High Volume,Declining,576,507112,405664
2431,3807905,1724085,98,2,Stable,Stable,532,761581,962504
2432,3946654,1439426,86,1,High Volume,Growth,617,1183996,255430
2433,1243621,473574,92,0,Stable,Stable,560,248724,224850
2434,1734626,313421,83,0,Stable,Stable,542,313421,0
2435,2485698,463745,85,0,Stable,Stable,559,463745,0
2436,1625047,653826,94,0,Unstable,Declining,469,325009,328817
2437,7173301,1316429,94,0,Stable,Declining,543,1316429,0
2438,2936650,890529,98,0,High Volume,Growth,696,880995,9534
2439,3569379,578984,87,0,Unstable,Growth,568,578984,0
2440,3369601,1407289,89,1,High Volume,Stable,571,673920,733369
2441,5069634,505572,100,0,Low Volume,Growth,637,505572,0
2442,2291729,969977,97,1,High Volume,Declining,542,458345,511632
2443,702594,225693,98,0,Stable,Declining,540,140518,85175
2444,2729831,366096,91,0,Stable,Stable,586,366096,0
2445,1177512,346090,88,1,Low Volume,Declining,446,235502,110588
2446,1299002,230085,92,0,Low Volume,Declining,511,230085,0
2447,3169522,619833,100,1,High Volume,Declining,557,619833,0
2448,5339414,1111600,90,0,Stable,Stable,581,1067882,43718
2449,2016789,158305,85,0,High Volume,Growth,674,158305,0
2450,2538456,1253192,94,0,High Volume,Growth,702,1015382,237810
2451,7738914,496765,84,0,High Volume,Growth,657,496765,0
2452,2403899,836854,96,0,High Volume,Stable,633,721169,115685
2453,15892319,3449467,96,0,Low Volume,Growth,599,3178463,271004
2454,3117082,1062004,93,0,Unstable,Growth,580,623416,438588
2455,500000,105156,80,1,Stable,Stable,501,100000,5156
2456,3622494,1279421,78,0,Low Volume,Growth,555,724498,554923
2457,2689664,1017113,93,0,Low Volume,Declining,502,537932,479181
2458,5563857,2007154,92,0,Low Volume,Declining,504,1112771,894383
2459,3397482,344107,98,0,High Volume,Stable,663,344107,0
2460,1774866,613397,95,0,Stable,Declining,549,354973,258424
2461,744569,131040,99,0,High Volume,Growth,696,131040,0
2462,1677443,105613,92,0,Stable,Declining,518,105613,0
2463,1004081,237640,85,0,High Volume,Declining,539,200816,36824
2464,1246165,305428,90,0,High Volume,Growth,687,305428,0
2465,3175141,826262,85,0,High Volume,Stable,602,826262,0
2466,7541439,2768997,91,0,Unstable,Stable,504,1508287,1260710
2467,2718898,513817,87,0,High Volume,Growth,670,513817,0
2468,761689,146150,94,0,Stable,Growth,612,146150,0
2469,2829702,218590,92,0,Low Volume,Growth,606,218590,0
2470,5164429,1854389,98,0,Stable,Stable,588,1032885,821504
2471,1217334,371922,83,0,Low Volume,Stable,517,243466,128456
2472,1781179,369134,95,1,Stable,Declining,479,356235,12899
2473,2006195,736946,95,0,Stable,Stable,580,401239,335707
2474,1058202,308795,88,0,Unstable,Growth,539,211640,97155
2475,3330471,869787,94,0,High Volume,Growth,671,869787,0
2476,1799900,504145,92,1,High Volume,Stable,581,359980,144165
2477,2773515,932890,83,0,High Volume,Growth,633,832054,100836
2478,974818,338263,98,0,Stable,Declining,524,194963,143300
2479,1397273,251552,93,0,Low Volume,Growth,583,251552,0
2480,3533873,400510,96,1,Unstable,Growth,529,400510,0
2481,1471413,177284,93,0,High Volume,Stable,646,177284,0
2482,7893665,2665895,94,0,High Volume,Declining,598,1578733,1087162
2483,1440198,637710,88,0,High Volume,Growth,663,432059,205651
2484,2373195,555976,98,0,Unstable,Growth,571,474639,81337
2485,4181049,528000,84,1,Stable,Declining,449,528000,0
2486,637499,248925,99,1,High Volume,Growth,643,191249,57676
2487,500000,212310,88,0,Low Volume,Stable,543,100000,112310
2488,585063,261091,82,1,High Volume,Growth,604,175518,85573
2489,5444232,1758891,88,0,Stable,Growth,618,1633269,125622
2490,1275072,557624,97,0,High Volume,Growth,685,382521,175103
2491,15348978,873921,95,0,Unstable,Stable,505,873921,0
2492,1262497,124048,97,0,High Volume,Stable,645,124048,0
2493,2298210,210652,94,0,High Volume,Growth,696,210652,0
2494,6808538,2523735,92,0,Stable,Growth,633,2042561,481174
2495,9868657,802438,90,0,High Volume,Declining,570,802438,0
2496,10315961,2820012,97,0,Stable,Stable,593,2063192,756820
2497,5213140,1369586,87,1,Stable,Stable,529,1042628,326958
2498,4498480,853886,96,0,High Volume,Growth,700,853886,0
2499,3185187,1406841,95,1,Stable,Growth,600,955556,451285
2500,3695731,468230,94,0,Unstable,Growth,564,468230,0
2501,1275758,266134,88,0,Low Volume,Stable,517,255151,10983
2502,1030383,410481,90,0,Unstable,Growth,572,206076,204405
2503,1977414,125942,91,0,Unstable,Stable,502,125942,0
2504,1730381,610526,82,0,Low Volume,Stable,534,346076,264450
2505,1379756,575881,96,0,Stable,Growth,637,413926,161955
2506,3461145,1625079,84,0,Low Volume,Growth,589,692229,932850
2507,4257719,1891847,88,0,Stable,Stable,574,851543,1040304
2508,2128069,412256,98,0,Stable,Growth,636,412256,0
2509,6465714,2029354,88,0,Low Volume,Growth,597,1293142,736212
2510,795438,67439,96,0,High Volume,Growth,678,67439,0
2511,1698188,281970,98,0,High Volume,Stable,650,281970,0
2512,1117430,103251,79,0,Unstable,Stable,463,103251,0
2513,500000,95917,94,0,Stable,Stable,576,95917,0
2514,1855854,823692,97,0,High Volume,Stable,631,556756,266936
2515,1798749,370947,97,0,High Volume,Declining,572,359749,11198
2516,6654207,2015254,84,0,Stable,Stable,542,1330841,684413
2517,3284252,804712,94,0,Low Volume,Growth,622,804712,0
2518,873838,224150,96,0,Low Volume,Stable,578,174767,49383
2519,8738718,4249703,84,0,Stable,Growth,606,2621615,1628088
2520,5266239,965141,80,0,High Volume,Growth,634,965141,0
2521,3158722,1049631,99,0,Low Volume,Growth,598,631744,417887
2522,1654175,395394,85,0,Unstable,Stable,496,330835,64559
2523,920294,71337,83,0,Stable,Stable,538,71337,0
2524,1472150,397773,83,0,High Volume,Stable,614,397773,0
2525,4737399,1970779,90,0,Stable,Growth,605,1421219,549560
2526,8954520,845654,92,0,High Volume,Growth,687,845654,0
2527,6814715,554148,88,0,Stable,Growth,606,554148,0
2528,1340992,159758,81,0,High Volume,Stable,604,159758,0
2529,809608,318969,88,0,Stable,Stable,579,161921,157048
2530,2219315,834014,95,0,Stable,Growth,616,665794,168220
2531,500000,152129,90,0,Stable,Declining,512,100000,52129
2532,2567734,669413,92,1,Low Volume,Growth,542,513546,155867
2533,1761926,792420,95,0,Stable,Stable,596,352385,440035
2534,1365691,539467,90,0,High Volume,Growth,686,409707,129760
2535,553622,229960,91,1,Stable,Declining,498,110724,119236
2536,2990287,1243864,90,1,Unstable,Stable,478,598057,645807
2537,1294764,439213,89,0,Low Volume,Growth,605,388429,50784
2538,777677,199168,94,0,Stable,Stable,572,155535,43633
2539,500000,219552,85,0,High Volume,Growth,646,150000,69552
2540,1939592,905214,87,0,Stable,Growth,626,581877,323337
2541,8184898,496927,96,0,Stable,Growth,644,496927,0
2542,7489461,548226,86,0,Unstable,Stable,504,548226,0
2543,1375493,662210,83,0,Stable,Growth,608,412647,249563
2544,1224729,213987,95,1,Low Volume,Stable,495,213987,0
2545,2884954,1278081,91,0,Stable,Stable,578,576990,701091
2546,892063,200677,98,0,High Volume,Growth,708,200677,0
2547,2524197,261494,92,0,Low Volume,Stable,533,261494,0
2548,3659599,315455,95,0,High Volume,Growth,692,315455,0
2549,5291152,637206,91,1,Stable,Stable,516,637206,0
2550,1830092,297302,84,0,Low Volume,Declining,482,297302,0
2551,1684638,454571,97,0,Unstable,Growth,572,336927,117644
2552,982263,359188,90,0,Stable,Stable,566,196452,162736
2553,1023251,505363,94,0,Stable,Growth,648,306975,198388
2554,1654182,411359,92,0,Stable,Growth,623,411359,0
2555,2660148,753309,96,0,Stable,Declining,551,532029,221280
2556,4117957,1172864,94,0,Low Volume,Declining,503,823591,349273
2557,1042838,305286,97,0,Low Volume,Stable,552,208567,96719
2558,6544600,1852012,93,0,Unstable,Growth,589,1308920,543092
2559,1596144,86110,93,0,Low Volume,Growth,613,86110,0
2560,1949154,98971,83,1,High Volume,Stable,551,98971,0
2561,1090591,102461,84,0,Stable,Stable,557,102461,0
2562,500000,47850,91,0,Stable,Stable,586,47850,0
2563,4021785,1476814,85,0,Stable,Stable,547,804357,672457
2564,3574998,508408,96,0,High Volume,Growth,670,508408,0
2565,1583167,716575,90,1,Stable,Growth,595,316633,399942
2566,2091919,978752,98,0,High Volume,Growth,711,836767,141985
2567,2995888,1465445,91,0,Stable,Growth,637,898766,566679
2568,568049,268452,93,0,High Volume,Growth,663,170414,98038
2569,1298549,223805,84,0,Stable,Growth,618,223805,0
2570,3743051,1045807,94,0,Stable,Growth,634,1045807,0
2571,726918,93740,91,0,Stable,Declining,536,93740,0
2572,2507624,1035133,91,0,Stable,Stable,559,501524,533609
2573,669800,301272,85,0,Stable,Stable,562,133960,167312
2574,2879548,1247075,90,0,Stable,Stable,580,575909,671166
2575,1927023,472150,96,0,Stable,Stable,608,472150,0
2576,544648,213177,92,0,High Volume,Growth,665,163394,49783
2577,5034332,472777,82,1,Stable,Stable,522,472777,0
2578,1101658,75034,94,0,High Volume,Stable,646,75034,0
2579,1036954,403330,93,1,High Volume,Stable,593,207390,195940
2580,2327849,561966,88,0,High Volume,Stable,599,465569,96397
2581,4969898,2474995,93,2,High Volume,Declining,516,993979,1481016
2582,879706,82485,93,0,Stable,Stable,595,82485,0
2583,2083050,906194,97,0,Stable,Declining,551,416610,489584
2584,2794191,743234,88,0,Low Volume,Stable,537,558838,184396
2585,3452070,1457525,94,1,Stable,Growth,600,1035621,421904
2586,2283348,953771,93,0,Stable,Stable,593,456669,497102
2587,1478262,683247,86,1,High Volume,Declining,534,295652,387595
2588,1022670,188205,96,0,High Volume,Stable,652,188205,0
2589,2124220,1014123,92,0,Stable,Declining,507,424844,589279
2590,840951,99443,81,2,High Volume,Growth,557,99443,0
2591,500000,43443,83,0,Stable,Growth,579,43443,0
2592,2811554,686657,92,0,Stable,Growth,630,686657,0
2593,4086289,1727460,94,0,Stable,Growth,621,1225886,501574
2594,500000,131520,94,0,Stable,Growth,645,131520,0
2595,884003,374092,96,0,High Volume,Declining,607,265200,108892
2596,3253765,1231091,92,0,Low Volume,Stable,530,650753,580338
2597,10282936,1483239,89,0,High Volume,Growth,664,1483239,0
2598,2016018,961634,96,0,High Volume,Growth,699,604805,356829
2599,1107480,85665,98,0,Low Volume,Stable,568,85665,0
2600,1712873,778031,93,2,Stable,Declining,430,342574,435457
2601,5955949,1113760,96,1,High Volume,Growth,658,1113760,0
2602,1182603,325295,95,0,Stable,Growth,646,325295,0
2603,1046170,251142,96,0,Stable,Growth,638,251142,0
2604,1347559,171579,98,1,High Volume,Growth,651,171579,0
2605,924804,195287,90,0,Low Volume,Stable,528,184960,10327
2606,2187208,299255,89,0,Stable,Declining,519,299255,0
2607,7273461,1031005,96,1,High Volume,Declining,565,1031005,0
2608,2567552,344503,90,1,Unstable,Stable,472,344503,0
2609,1620292,437573,93,2,High Volume,Growth,594,324058,113515
2610,1569945,642216,83,1,High Volume,Growth,603,470983,171233
2611,567756,173754,96,0,High Volume,Growth,691,170326,3428
2612,4018776,1816258,83,1,High Volume,Growth,629,1205632,610626
2613,1863059,626817,97,2,High Volume,Stable,578,372611,254206
2614,1716188,618176,96,1,Stable,Growth,593,343237,274939
2615,25507576,8938448,89,0,Stable,Declining,517,5101515,3836933
2616,2518068,635199,90,1,Low Volume,Growth,555,503613,131586
2617,1086603,391397,98,1,Stable,Growth,618,325980,65417
2618,1409737,114708,93,0,Stable,Growth,634,114708,0
2619,4969136,2171180,93,0,Stable,Growth,644,1490740,680440
2620,2170822,868362,94,0,Low Volume,Growth,584,434164,434198
2621,627424,100610,90,0,Stable,Stable,575,100610,0
2622,4136593,1636497,94,0,Low Volume,Growth,588,827318,809179
2623,1161804,64700,96,0,High Volume,Declining,590,64700,0
2624,8874018,1311233,84,0,High Volume,Stable,622,1311233,0
2625,4704540,373125,84,0,High Volume,Declining,550,373125,0
2626,1386291,556044,87,1,Stable,Growth,563,277258,278786
2627,5525107,2155584,90,0,Unstable,Growth,562,1105021,1050563
2628,2093367,871126,89,0,High Volume,Declining,547,418673,452453
2629,3922418,204031,86,1,Stable,Stable,503,204031,0
2630,2922022,805177,88,0,High Volume,Growth,651,805177,0
2631,1007432,369905,89,0,Stable,Growth,634,302229,67676
2632,1184890,142104,96,1,Stable,Stable,555,142104,0
2633,4519756,1547591,94,1,Low Volume,Growth,569,903951,643640
2634,1516901,133259,91,0,Low Volume,Stable,538,133259,0
2635,1435582,188918,89,0,Stable,Growth,628,188918,0
2636,923478,243898,90,1,Unstable,Growth,522,184695,59203
2637,2782553,957489,88,0,Stable,Stable,549,556510,400979
2638,10324393,1193924,98,0,Unstable,Stable,520,1193924,0
2639,844056,112555,91,0,High Volume,Stable,609,112555,0
2640,2021551,287062,93,1,Low Volume,Declining,447,287062,0
2641,6136570,965990,91,0,Stable,Declining,528,965990,0
2642,1860372,282682,98,0,Low Volume,Growth,612,282682,0
2643,2847345,648674,93,1,Unstable,Growth,535,569469,79205
2644,847533,291725,86,0,Unstable,Growth,568,169506,122219
2645,2793053,690203,84,0,Stable,Stable,544,558610,131593
2646,1707062,681439,98,0,Stable,Growth,644,512118,169321
2647,4362623,1630185,80,0,Stable,Growth,597,872524,757661
2648,5126372,548199,88,0,Low Volume,Stable,517,548199,0
2649,15738979,1132872,93,1,Stable,Declining,476,1132872,0
2650,3152501,1403095,95,0,Low Volume,Growth,617,945750,457345
2651,2573139,221094,88,2,High Volume,Growth,578,221094,0
2652,2316360,270441,93,0,Stable,Growth,615,270441,0
2653,1494746,89625,86,0,Stable,Growth,593,89625,0
2654,2599389,864950,90,0,High Volume,Declining,565,519877,345073
2655,1565442,488522,94,1,High Volume,Growth,623,469632,18890
2656,2268816,1121037,85,1,Stable,Stable,519,453763,667274
2657,5689188,2555126,85,0,High Volume,Growth,653,1706756,848370
2658,886260,208164,90,0,Low Volume,Growth,606,208164,0
2659,4935196,1071992,90,0,Unstable,Growth,544,987039,84953
2660,5686992,1044037,88,1,High Volume,Growth,623,1044037,0
2661,1804051,213930,89,0,Low Volume,Growth,589,213930,0
2662,500000,56069,88,0,Stable,Growth,608,56069,0
2663,1219245,133541,94,0,Stable,Stable,570,133541,0
2664,5596185,567183,81,0,Stable,Growth,579,567183,0
2665,1946816,308046,96,0,Low Volume,Growth,624,308046,0
2666,891409,167586,97,0,Unstable,Growth,563,167586,0
2667,1324016,639116,93,2,Stable,Stable,502,264803,374313
2668,3884466,1205400,92,1,Low Volume,Growth,556,776893,428507
2669,3070610,1518165,98,1,Stable,Stable,563,614122,904043
2670,1637783,356398,96,0,Stable,Growth,635,356398,0
2671,1478503,378396,96,0,High Volume,Growth,683,378396,0
2672,1449303,284151,96,2,High Volume,Stable,554,284151,0
2673,947964,125415,89,0,Stable,Stable,573,125415,0
2674,7219531,826088,97,0,Stable,Growth,630,826088,0
2675,1532090,728180,89,0,High Volume,Growth,666,459627,268553
2676,5249938,2593810,94,0,Stable,Stable,582,1049987,1543823
2677,6696214,470136,87,1,High Volume,Growth,615,470136,0
2678,4406753,518479,91,0,Low Volume,Growth,583,518479,0
2679,1403815,337738,94,1,Stable,Stable,531,280763,56975
2680,2738673,366572,91,0,Stable,Declining,516,366572,0
2681,1944749,415683,85,2,Stable,Declining,413,388949,26734
2682,962259,104014,86,0,Unstable,Stable,507,104014,0
2683,2570182,656502,99,0,Unstable,Growth,581,514036,142466
2684,772022,132990,84,2,Low Volume,Stable,438,132990,0
2685,5127576,1068368,90,0,Stable,Declining,531,1025515,42853
2686,1367242,126389,97,0,High Volume,Growth,703,126389,0
2687,2328949,565137,95,0,Stable,Stable,580,465789,99348
2688,2487106,1224815,96,0,Low Volume,Stable,556,497421,727394
2689,1611822,319100,88,0,Stable,Growth,595,319100,0
2690,3170358,1408885,93,0,Low Volume,Declining,482,634071,774814
2691,1356037,582336,92,0,High Volume,Growth,660,406811,175525
2692,3980977,1904604,96,3,High Volume,Declining,485,796195,1108409
2693,675505,273951,85,0,Stable,Growth,592,135101,138850
2694,2193708,760819,88,1,Stable,Declining,493,438741,322078
2695,9352397,4072623,90,1,Stable,Growth,583,1870479,2202144
2696,890675,74852,95,0,Stable,Stable,595,74852,0
2697,1152915,297768,95,0,Low Volume,Growth,605,297768,0
2698,2991024,1481051,84,0,Stable,Growth,595,598204,882847
2699,2289091,907213,94,0,High Volume,Declining,568,457818,449395
2700,2624771,1267591,92,0,Stable,Growth,608,787431,480160
2701,2932453,1175431,96,1,Stable,Stable,553,586490,588941
2702,3294540,1461777,89,1,Unstable,Declining,424,658908,802869
2703,4817472,1772533,84,0,Unstable,Stable,490,963494,809039
2704,2752045,1079423,97,0,High Volume,Stable,633,825613,253810
2705,1634739,466604,92,1,High Volume,Stable,566,326947,139657
2706,3395831,1582141,99,0,Stable,Growth,665,1018749,563392
2707,9064766,3818691,90,0,Stable,Growth,637,2719429,1099262
2708,1783152,766306,92,0,High Volume,Stable,614,534945,231361
2709,909251,320833,90,0,Stable,Declining,520,181850,138983
2710,4807388,899275,99,0,High Volume,Stable,627,899275,0
2711,1800716,118907,87,0,Stable,Stable,548,118907,0
2712,500000,235522,89,0,Low Volume,Stable,538,100000,135522
2713,3905660,1225417,88,0,Stable,Stable,569,781132,444285
2714,1292046,237949,89,1,Stable,Growth,584,237949,0
2715,1844232,215979,93,0,Unstable,Declining,465,215979,0
2716,2585900,1094574,94,0,High Volume,Stable,632,775770,318804
2717,2309172,984710,98,0,Stable,Declining,551,461834,522876
2718,3497509,1456812,88,0,High Volume,Growth,661,1049252,407560
2719,1399479,476225,90,0,High Volume,Growth,682,419843,56382
2720,2989105,641782,82,1,Stable,Growth,564,597821,43961
2721,1610995,300985,95,0,High Volume,Declining,595,300985,0
2722,3580627,192815,84,0,Stable,Declining,493,192815,0
2723,3243923,1379068,86,0,High Volume,Stable,606,973176,405892
2724,938135,83817,98,0,Stable,Stable,606,83817,0
2725,4726926,1578036,97,0,Stable,Growth,650,1418077,159959
2726,1291389,357500,90,0,High Volume,Growth,655,357500,0
2727,3784583,1086214,86,0,Low Volume,Stable,527,756916,329298
2728,2659982,1242267,93,0,Stable,Growth,641,797994,444273
2729,8628204,554162,93,1,Stable,Stable,547,554162,0
2730,1658173,659997,96,0,Stable,Growth,652,497451,162546
2731,1499356,110088,96,0,High Volume,Stable,643,110088,0
2732,1952194,131127,93,0,Stable,Growth,631,131127,0
2733,1555731,378693,91,1,Stable,Declining,499,311146,67547
2734,3760090,294730,90,0,Unstable,Growth,566,294730,0
2735,544134,220437,88,0,Low Volume,Growth,586,108826,111611
2736,853460,246055,91,0,High Volume,Growth,690,246055,0
2737,843873,53221,96,0,High Volume,Growth,697,53221,0
2738,4240730,289325,94,0,High Volume,Stable,629,289325,0
2739,7791085,2537563,94,1,High Volume,Stable,601,2337325,200238
2740,1823814,752780,95,0,Stable,Declining,533,364762,388018
2741,1732269,427887,90,1,High Volume,Stable,560,346453,81434
2742,2097049,628195,96,1,Stable,Stable,531,419409,208786
2743,5022823,2058972,82,0,High Volume,Stable,592,1004564,1054408
2744,944223,306615,87,0,Low Volume,Declining,497,188844,117771
2745,2399318,362638,85,0,Stable,Growth,590,362638,0
2746,4326018,1409734,87,0,Unstable,Stable,520,865203,544531
2747,2960520,985041,96,0,Unstable,Declining,498,592104,392937
2748,2307477,877645,94,0,Stable,Growth,642,692243,185402
2749,4416406,1454735,88,1,High Volume,Growth,641,1324921,129814
2750,500000,243079,97,0,High Volume,Stable,642,150000,93079
2751,3410264,473276,96,1,High Volume,Growth,648,473276,0
2752,1174954,561617,92,1,Stable,Growth,587,234990,326627
2753,500000,146126,88,0,Stable,Stable,578,100000,46126
2754,2984558,1051699,92,0,Stable,Stable,584,596911,454788
2755,5950149,563823,94,0,High Volume,Growth,685,563823,0
2756,1776297,393022,93,0,Stable,Growth,625,393022,0
2757,4249448,1683719,91,1,High Volume,Growth,648,1274834,408885
2758,7201664,2651004,89,0,Low Volume,Stable,539,1440332,1210672
2759,5676989,386391,90,0,High Volume,Stable,609,386391,0
2760,7362953,2179194,97,2,Stable,Stable,519,1472590,706604
2761,3590141,322126,85,0,Stable,Growth,621,322126,0
2762,2106097,1049121,95,0,Stable,Growth,641,631829,417292
2763,550415,249769,87,0,High Volume,Growth,660,165124,84645
2764,1628468,96872,97,0,Unstable,Growth,572,96872,0
2765,1009941,440730,85,0,Stable,Declining,522,201988,238742
2766,11259854,5221682,97,1,Stable,Growth,586,2251970,2969712
2767,1722507,360171,85,0,High Volume,Declining,560,344501,15670
2768,2188143,817875,87,0,Low Volume,Growth,584,437628,380247
2769,3082305,767330,94,0,High Volume,Stable,613,767330,0
2770,2053142,708036,84,0,High Volume,Declining,535,410628,297408
2771,7694688,1563121,84,0,Stable,Declining,511,1538937,24184
2772,1204868,235132,95,0,Unstable,Stable,506,235132,0
2773,2316773,558331,93,0,High Volume,Growth,690,558331,0
2774,1094736,126448,93,0,High Volume,Growth,664,126448,0
2775,689679,292433,94,0,Low Volume,Growth,582,137935,154498
2776,1215401,251484,90,0,Low Volume,Growth,592,243080,8404
2777,1924873,442850,91,0,Low Volume,Growth,601,442850,0
2778,1406420,636158,97,1,Stable,Stable,538,281284,354874
2779,1139458,311620,99,0,Stable,Stable,600,311620,0
2780,643673,189828,88,0,Stable,Growth,606,189828,0
2781,1855223,891294,84,0,Stable,Stable,543,371044,520250
2782,594945,267146,95,0,Unstable,Growth,559,118989,148157
2783,3642004,459839,89,1,Stable,Declining,475,459839,0
2784,2117934,556904,96,2,High Volume,Growth,605,556904,0
2785,617824,300932,97,0,High Volume,Growth,685,185347,115585
2786,1548245,336844,88,0,Unstable,Declining,445,309649,27195
2787,1086286,235950,94,1,Stable,Growth,582,217257,18693
2788,2559544,352612,91,0,Stable,Stable,557,352612,0
2789,5794156,587790,97,1,Stable,Growth,599,587790,0
2790,500000,191569,83,0,High Volume,Declining,530,100000,91569
2791,2173873,861970,95,2,Stable,Declining,470,434774,427196
2792,1744352,847852,96,0,Low Volume,Declining,496,348870,498982
2793,3392481,1350337,89,2,Stable,Growth,524,678496,671841
2794,2351484,375082,97,0,Low Volume,Growth,621,375082,0
2795,1086448,73935,93,0,Low Volume,Stable,558,73935,0
2796,1536099,757983,93,0,Stable,Declining,522,307219,450764
2797,1048823,213124,99,0,Low Volume,Growth,619,213124,0
2798,4689355,892793,99,1,Low Volume,Growth,563,892793,0
2799,2016854,923073,99,0,Stable,Declining,547,403370,519703
2800,9074261,2842920,93,0,Stable,Stable,566,1814852,1028068
2801,1888836,277077,99,0,High Volume,Stable,630,277077,0
2802,1124979,506346,98,0,Stable,Growth,631,337493,168853
2803,590679,293575,97,0,Stable,Growth,661,177203,116372
2804,500000,44503,84,0,Unstable,Stable,482,44503,0
2805,558322,244552,94,0,High Volume,Stable,635,167496,77056
2806,2455157,554208,90,0,Low Volume,Growth,578,491031,63177
2807,2978648,851395,93,0,High Volume,Growth,675,851395,0
2808,559639,258367,85,0,Unstable,Growth,542,111927,146440
2809,4057310,1980051,91,1,Stable,Growth,583,811462,1168589
2810,1347216,226297,91,0,Stable,Declining,533,226297,0
2811,2229827,325071,94,0,Stable,Declining,520,325071,0
2812,7201332,620989,90,0,High Volume,Growth,683,620989,0
2813,4063160,1230362,84,0,Low Volume,Growth,568,812632,417730
2814,1599458,89765,100,1,Stable,Stable,560,89765,0
2815,971937,228749,99,0,Low Volume,Growth,619,228749,0
2816,500000,41511,87,1,Stable,Growth,586,41511,0
2817,1115348,259153,95,1,High Volume,Stable,608,259153,0
2818,1674618,113823,95,0,Stable,Stable,574,113823,0
2819,900096,383304,92,1,Low Volume,Stable,515,180019,203285
2820,1785117,257740,89,0,Unstable,Growth,572,257740,0
2821,2108488,416930,91,0,Stable,Stable,584,416930,0
2822,1656331,731306,90,1,High Volume,Stable,586,331266,400040
2823,1178789,454800,94,0,Stable,Growth,612,353636,101164
2824,2269168,337124,88,0,Stable,Growth,610,337124,0
2825,2823683,232544,94,0,Stable,Growth,620,232544,0
2826,828756,308341,96,1,High Volume,Stable,595,165751,142590
2827,6130249,1384309,97,1,High Volume,Growth,652,1384309,0
2828,1832386,723309,89,0,Stable,Growth,626,549715,173594
2829,2012885,503991,84,0,Low Volume,Growth,562,402577,101414
2830,3494048,718729,88,0,High Volume,Stable,632,718729,0
2831,2389448,604632,92,0,High Volume,Growth,670,604632,0
2832,4250339,1644250,85,0,Low Volume,Growth,590,850067,794183
2833,2494751,1137604,98,0,Stable,Growth,635,748425,389179
2834,1214752,87942,97,0,Stable,Growth,646,87942,0
2835,2647702,756846,91,2,High Volume,Declining,478,529540,227306
2836,794143,51441,79,0,Stable,Stable,551,51441,0
2837,2162656,563987,95,1,Low Volume,Stable,496,432531,131456
2838,1930744,865702,88,0,High Volume,Growth,666,579223,286479
2839,1678660,357077,86,0,High Volume,Stable,591,335732,21345
2840,1789005,840122,86,0,Low Volume,Growth,595,357801,482321
2841,500000,166887,84,0,Stable,Growth,584,100000,66887
2842,1278272,601261,86,3,Stable,Growth,476,255654,345607
2843,2135638,834447,92,0,Low Volume,Declining,494,427127,407320
2844,2253252,217542,92,1,Stable,Declining,467,217542,0
2845,871403,134212,98,0,High Volume,Growth,692,134212,0
2846,5457854,1240989,90,0,High Volume,Declining,550,1091570,149419
2847,991585,125483,93,1,High Volume,Growth,625,125483,0
2848,4306197,1174344,88,1,Stable,Stable,513,861239,313105
2849,2790567,731451,87,1,Unstable,Stable,445,558113,173338
2850,1182354,567904,87,0,High Volume,Stable,630,354706,213198
2851,8204954,2011670,86,1,High Volume,Growth,604,2011670,0
2852,763059,307919,90,0,Stable,Growth,637,228917,79002
2853,4136346,1960048,84,0,High Volume,Stable,591,827269,1132779
2854,4414768,1963004,94,0,High Volume,Stable,635,1324430,638574
2855,1159505,166853,87,2,High Volume,Growth,566,166853,0
2856,6040348,1650304,86,1,Stable,Stable,536,1208069,442235
2857,1623286,335181,94,0,Stable,Growth,618,335181,0
2858,2497885,574355,96,0,High Volume,Growth,697,574355,0
2859,2441828,518554,98,0,Stable,Growth,650,518554,0
2860,1780764,751236,87,0,High Volume,Growth,673,534229,217007
2861,3792920,961363,97,0,Stable,Stable,573,758584,202779
2862,3740729,1068586,94,0,High Volume,Declining,600,1068586,0
2863,500000,246051,96,0,Stable,Stable,571,100000,146051
2864,5629168,433393,99,0,Stable,Stable,613,433393,0
2865,524398,141368,98,0,High Volume,Growth,678,141368,0
2866,4529114,1804072,84,1,High Volume,Growth,629,1358734,445338
2867,4883458,576360,87,0,High Volume,Growth,671,576360,0
2868,828380,269380,93,0,Stable,Stable,598,165676,103704
2869,1427376,225182,92,0,Low Volume,Growth,597,225182,0
2870,818670,360486,83,0,Low Volume,Growth,589,163734,196752
2871,1669547,329226,94,0,Stable,Stable,569,329226,0
2872,1549701,306962,97,0,Low Volume,Growth,622,306962,0
2873,3699575,1180857,88,0,Low Volume,Growth,579,739915,440942
2874,5656110,750019,91,0,Stable,Declining,516,750019,0
2875,6055921,1079164,96,0,Stable,Declining,553,1079164,0
2876,1264599,300322,87,1,Low Volume,Growth,526,252919,47403
2877,1677177,350760,89,0,Stable,Growth,611,350760,0
2878,515684,147586,92,1,Stable,Growth,576,103136,44450
2879,1040596,332822,96,0,Stable,Growth,643,312178,20644
2880,4290360,1308561,97,0,Unstable,Growth,581,858072,450489
2881,7220727,2486643,93,0,Stable,Growth,625,2166218,320425
2882,738607,139218,90,0,High Volume,Growth,676,139218,0
2883,1234317,131938,91,0,High Volume,Growth,683,131938,0
2884,1941314,761701,90,2,Stable,Stable,483,388262,373439
2885,2480892,1073857,77,0,Stable,Stable,543,496178,577679
2886,1037492,171863,82,0,High Volume,Growth,627,171863,0
2887,2783581,649107,96,0,Low Volume,Growth,610,649107,0
2888,1357192,372354,97,0,Stable,Stable,608,372354,0
2889,1959967,568385,91,0,Stable,Declining,539,391993,176392
2890,3069507,1064415,89,0,High Volume,Growth,672,920852,143563
2891,1992973,136960,93,0,Stable,Growth,610,136960,0
2892,1398473,523958,93,0,Stable,Stable,594,279694,244264
2893,1816300,141466,98,0,Low Volume,Declining,520,141466,0
2894,1847437,481682,87,0,Unstable,Declining,443,369487,112195
2895,1474738,623006,92,0,High Volume,Growth,659,442421,180585
2896,1611963,407902,92,0,High Volume,Growth,679,407902,0
2897,7123557,834100,88,1,Stable,Declining,477,834100,0
2898,3105656,1531912,88,0,Unstable,Growth,544,621131,910781
2899,1565343,704684,87,1,High Volume,Growth,640,469602,235082
2900,3462715,1375013,98,1,Low Volume,Stable,520,692543,682470
2901,1518061,357018,95,1,Stable,Stable,563,303612,53406
2902,5068217,672707,95,0,Stable,Declining,537,672707,0
2903,2664998,1262236,92,1,Unstable,Stable,494,532999,729237
2904,1819656,526896,92,0,Stable,Growth,641,526896,0
2905,2836761,1229906,86,0,Low Volume,Growth,593,567352,662554
2906,564276,115080,97,0,Stable,Declining,525,112855,2225
2907,804991,161706,94,0,Low Volume,Growth,611,161706,0
2908,762883,376478,95,1,Stable,Stable,531,152576,223902
2909,2222970,633157,97,0,Low Volume,Stable,542,444594,188563
2910,7928798,898435,89,0,Stable,Stable,586,898435,0
2911,11816886,1758986,92,0,Stable,Stable,585,1758986,0
2912,3303328,881575,89,1,High Volume,Growth,635,881575,0
2913,2959928,204566,92,0,High Volume,Stable,620,204566,0
2914,500000,129070,91,0,Stable,Declining,513,100000,29070
2915,1284475,306377,87,0,High Volume,Stable,597,256895,49482
2916,1055762,423045,88,0,High Volume,Declining,562,211152,211893
2917,1206606,253054,88,0,Stable,Stable,573,241321,11733
2918,1733209,852994,94,0,Unstable,Growth,589,346641,506353
2919,1359092,178512,86,1,Stable,Declining,454,178512,0
2920,500000,157972,97,0,Stable,Growth,656,150000,7972
2921,3606788,325926,87,0,High Volume,Growth,654,325926,0
2922,840545,319608,85,0,High Volume,Stable,608,252163,67445
2923,2401004,1194834,90,0,Stable,Growth,604,720301,474533
2924,10420297,4362065,94,0,Low Volume,Growth,592,2084059,2278006
2925,950261,285142,84,0,Unstable,Growth,560,190052,95090
2926,500000,134067,97,1,Low Volume,Growth,577,100000,34067
2927,1577255,671538,88,0,High Volume,Stable,619,473176,198362
2928,4783905,2254120,86,0,Stable,Stable,553,956781,1297339
2929,9498818,4703273,95,0,Stable,Stable,573,1899763,2803510
2930,741448,169378,84,0,Unstable,Declining,429,148289,21089
2931,2950129,1463007,93,0,Low Volume,Growth,609,885038,577969
2932,1366484,164206,87,0,Low Volume,Growth,574,164206,0
2933,1821628,298924,98,1,Stable,Declining,491,298924,0
2934,16444057,1480907,94,1,Stable,Stable,559,1480907,0
2935,595778,102642,87,0,Stable,Stable,569,102642,0
2936,2429004,960846,91,0,Stable,Stable,584,485800,475046
2937,2882460,1250457,97,1,Low Volume,Growth,570,576492,673965
2938,4726186,1892845,86,1,High Volume,Stable,569,945237,947608
2939,2144435,716198,91,1,Unstable,Growth,524,428887,287311
2940,2536867,713582,99,1,Low Volume,Growth,557,507373,206209
2941,1449430,534719,88,0,Stable,Declining,526,289886,244833
2942,2459089,555447,88,1,Low Volume,Growth,564,491817,63630
2943,1506721,645764,87,0,Low Volume,Growth,597,301344,344420
2944,3260064,1156461,97,1,Stable,Growth,611,978019,178442
2945,1475211,536995,87,0,Low Volume,Growth,599,295042,241953
2946,2680946,780614,85,0,High Volume,Declining,549,536189,244425
2947,1936881,868406,92,0,Stable,Growth,611,581064,287342
2948,4880900,797571,92,0,High Volume,Declining,588,797571,0
2949,1902891,421522,89,0,High Volume,Growth,652,421522,0
2950,500000,199970,88,0,Low Volume,Declining,474,100000,99970
2951,5441347,1478615,95,1,Stable,Growth,596,1088269,390346
2952,960697,432454,87,1,Stable,Growth,568,192139,240315
2953,1175245,241959,86,0,Stable,Growth,597,235049,6910
2954,1231164,266176,86,0,Stable,Growth,615,266176,0
2955,5953861,2678827,92,0,Stable,Stable,581,1190772,1488055
2956,500000,129483,92,0,Low Volume,Stable,543,100000,29483
2957,24402565,6887772,85,0,Low Volume,Declining,462,4880513,2007259
2958,4615106,921838,89,0,Stable,Declining,502,921838,0
2959,2370452,413647,97,0,Low Volume,Growth,616,413647,0
2960,1897570,654997,94,0,Stable,Growth,642,569271,85726
2961,2491619,258950,99,0,Low Volume,Growth,629,258950,0
2962,3008337,1340734,83,0,Stable,Growth,607,902501,438233
2963,3322315,1331057,96,0,Stable,Growth,636,996694,334363
2964,3092479,420072,91,0,Low Volume,Declining,499,420072,0
2965,2130068,771743,94,0,Stable,Growth,629,639020,132723
2966,1693197,543829,87,1,Low Volume,Stable,474,338639,205190
2967,1756759,233721,82,0,Low Volume,Declining,468,233721,0
2968,1696492,293394,94,1,Stable,Growth,579,293394,0
2969,4911137,1149422,87,0,Stable,Stable,580,982227,167195
2970,3187812,1162465,87,0,Unstable,Stable,504,637562,524903
2971,500000,168713,94,1,High Volume,Declining,526,100000,68713
2972,3350837,970086,90,1,Low Volume,Growth,540,670167,299919
2973,2317012,917038,94,1,Stable,Stable,535,463402,453636
2974,1953304,763882,86,0,Low Volume,Stable,518,390660,373222
2975,1453064,476658,92,1,Stable,Stable,528,290612,186046
2976,4873340,1969539,87,0,Stable,Stable,562,974668,994871
2977,4231306,848032,90,1,High Volume,Stable,599,846261,1771
2978,1068427,477119,92,0,Unstable,Growth,559,213685,263434
2979,2745961,897132,87,1,High Volume,Declining,520,549192,347940
2980,911343,382822,94,0,Stable,Growth,612,273402,109420
2981,657569,194526,83,1,Stable,Growth,559,131513,63013
2982,1200953,178098,87,0,Low Volume,Growth,585,178098,0
2983,3952721,1162434,83,1,Stable,Growth,566,790544,371890
2984,4250300,922316,95,2,High Volume,Declining,521,850060,72256
2985,2989056,1087641,92,0,Stable,Stable,587,597811,489830
2986,3541556,935350,87,0,High Volume,Declining,576,708311,227039
2987,2996461,1277244,96,0,High Volume,Declining,603,898938,378306
2988,1186852,421490,96,0,Stable,Growth,619,356055,65435
2989,2801143,1002935,93,1,Stable,Stable,558,560228,442707
2990,3761497,555648,94,0,High Volume,Growth,690,555648,0
2991,3625247,1786929,93,0,High Volume,Declining,574,725049,1061880
2992,5132640,2200639,95,0,Stable,Stable,591,1026528,1174111
2993,3494298,1415373,93,0,Low Volume,Growth,587,698859,716514
2994,2626489,521612,94,0,Low Volume,Growth,621,521612,0
2995,4667435,1358383,98,0,High Volume,Stable,628,1358383,0
2996,1941134,216818,95,0,Low Volume,Growth,597,216818,0
2997,979209,286237,91,0,High Volume,Stable,627,286237,0
2998,1740262,201262,95,1,Stable,Growth,579,201262,0
2999,1092608,326545,94,0,Low Volume,Stable,540,218521,108024
3000,1155285,395021,95,0,Stable,Growth,633,346585,48436
3001,1766278,398451,99,0,Stable,Stable,581,353255,45196
3002,1051853,288571,88,0,Unstable,Growth,565,210370,78201
3003,1549791,688175,87,1,High Volume,Growth,608,464937,223238
3004,500000,49427,97,0,High Volume,Growth,689,49427,0
3005,2351667,955435,85,0,Low Volume,Growth,557,470333,485102
3006,1984672,251735,94,1,Low Volume,Declining,464,251735,0
3007,1031298,68600,95,0,Stable,Growth,624,68600,0
3008,3359815,448564,84,0,Stable,Growth,601,448564,0
3009,4197737,1655039,88,2,High Volume,Growth,601,1259321,395718
3010,547957,127294,95,1,Low Volume,Growth,565,109591,17703
3011,1077140,476779,97,0,Stable,Growth,639,323142,153637
3012,1071624,306611,94,0,Stable,Growth,625,306611,0
3013,934790,56099,89,0,High Volume,Growth,648,56099,0
3014,3849985,1434201,99,0,Stable,Stable,608,1154995,279206
3015,1697962,169125,95,1,Stable,Growth,600,169125,0
3016,1604605,650219,90,0,High Volume,Stable,636,481381,168838
3017,500000,62823,94,1,Low Volume,Growth,581,62823,0
3018,3296377,677244,89,0,High Volume,Growth,674,677244,0
3019,735711,288820,99,0,Low Volume,Growth,620,220713,68107
3020,2080141,997228,94,0,Low Volume,Stable,549,416028,581200
3021,2475373,537516,87,0,Low Volume,Stable,527,495074,42442
3022,5888588,2492228,86,0,Stable,Growth,624,1766576,725652
3023,695888,94541,91,0,Stable,Declining,521,94541,0
3024,500000,206615,90,1,Stable,Stable,522,100000,106615
3025,2296920,794441,91,0,Low Volume,Growth,592,459384,335057
3026,8372047,1144748,96,0,High Volume,Growth,684,1144748,0
3027,5342248,994335,94,1,High Volume,Stable,598,994335,0
3028,2344840,256284,96,0,High Volume,Stable,621,256284,0
3029,1338006,297486,89,0,Low Volume,Growth,597,267601,29885
3030,3781752,535654,97,0,Low Volume,Declining,516,535654,0
3031,909966,309206,93,0,High Volume,Growth,695,272989,36217
3032,2902509,1444077,98,1,Stable,Growth,584,580501,863576
3033,2970902,164600,80,0,Stable,Stable,531,164600,0
3034,4630465,1358643,88,0,High Volume,Growth,659,1358643,0
3035,18033254,5556947,98,0,Stable,Stable,607,5409976,146971
3036,2713996,1252221,88,0,High Volume,Growth,667,814198,438023
3037,1319587,366452,84,0,High Volume,Growth,672,366452,0
3038,1942605,572419,92,0,High Volume,Growth,679,572419,0
3039,500000,131122,96,0,High Volume,Growth,704,131122,0
3040,1137370,194498,90,0,High Volume,Growth,653,194498,0
3041,1429127,107489,83,0,Unstable,Stable,476,107489,0
3042,1303716,304934,89,1,Stable,Growth,572,260743,44191
3043,2239770,164995,81,1,High Volume,Declining,491,164995,0
3044,1026909,305733,81,1,Stable,Stable,523,205381,100352
3045,4861339,915303,91,0,High Volume,Stable,626,915303,0
3046,1983088,575336,96,0,Stable,Growth,656,575336,0
3047,1968062,217340,94,1,Low Volume,Growth,542,217340,0
3048,1525273,716396,95,0,Stable,Growth,617,457581,258815
3049,2244857,1015875,86,1,Stable,Stable,506,448971,566904
3050,3836529,519844,94,1,Stable,Stable,557,519844,0
3051,990828,202674,93,0,Stable,Growth,619,202674,0
3052,1171162,381883,86,0,High Volume,Stable,628,351348,30535
3053,1555051,144711,90,0,Stable,Declining,502,144711,0
3054,675564,141568,81,0,Unstable,Growth,546,135112,6456
3055,1029510,167811,92,0,Low Volume,Stable,560,167811,0
3056,1354609,625806,81,1,Low Volume,Declining,418,270921,354885
3057,3990836,1730545,89,0,High Volume,Growth,660,1197250,533295
3058,2446207,760586,97,0,Stable,Growth,656,733862,26724
3059,2314888,657789,95,0,Low Volume,Growth,587,462977,194812
3060,3916537,1836177,98,0,High Volume,Growth,679,1174961,661216
3061,1776406,834187,93,0,Low Volume,Growth,594,355281,478906
3062,2709763,1317483,95,0,High Volume,Growth,704,1083905,233578
3063,1825606,194282,82,2,Unstable,Growth,467,194282,0
3064,2451694,299722,93,0,High Volume,Growth,692,299722,0
3065,1243938,441015,92,0,Stable,Growth,637,373181,67834
3066,500000,146823,84,0,High Volume,Growth,664,146823,0
3067,1780806,103838,88,0,High Volume,Stable,606,103838,0
3068,6188470,482012,90,0,Low Volume,Stable,547,482012,0
3069,4159778,1870387,93,1,High Volume,Stable,586,831955,1038432
3070,4292234,1892840,86,0,Low Volume,Declining,494,858446,1034394
3071,5330228,1123462,98,1,Unstable,Growth,547,1066045,57417
3072,2128496,959894,97,1,Unstable,Growth,521,425699,534195
3073,2321798,736367,92,2,Low Volume,Declining,424,464359,272008
3074,1209695,499190,95,0,Unstable,Growth,581,241939,257251
3075,1539767,373153,92,0,High Volume,Stable,619,373153,0
3076,3244971,327837,91,0,Unstable,Growth,566,327837,0
3077,5194482,1273568,97,0,High Volume,Stable,635,1273568,0
3078,1773460,453624,96,0,High Volume,Declining,577,354692,98932
3079,1383115,412064,93,0,High Volume,Stable,632,412064,0
3080,1983597,193425,96,0,Low Volume,Growth,603,193425,0
3081,3207381,1591281,100,0,High Volume,Stable,660,962214,629067
3082,624631,99854,97,0,High Volume,Growth,699,99854,0
3083,500000,69674,94,0,Stable,Declining,520,69674,0
3084,1276421,366411,81,0,Stable,Growth,608,366411,0
3085,746708,217847,97,0,High Volume,Declining,581,149341,68506
3086,1320456,327367,86,0,Stable,Stable,556,264091,63276
3087,1761675,700004,94,0,Stable,Growth,627,528502,171502
3088,1379734,389767,91,0,Stable,Stable,561,275946,113821
3089,6337368,2055607,95,0,Stable,Growth,641,1901210,154397
3090,2575092,967426,96,1,Unstable,Stable,501,515018,452408
3091,2521538,154473,91,0,Low Volume,Stable,533,154473,0
3092,3261722,1000663,91,0,High Volume,Growth,671,978516,22147
3093,797258,357082,97,1,High Volume,Growth,638,239177,117905
3094,4552966,263275,93,0,Unstable,Declining,468,263275,0
3095,1866151,433566,90,0,Stable,Growth,640,433566,0
3096,3390149,1582530,82,0,Low Volume,Growth,556,678029,904501
3097,841141,175731,84,1,Stable,Stable,504,168228,7503
3098,572056,146691,89,0,Low Volume,Stable,533,114411,32280
3099,3814468,1875550,93,2,High Volume,Declining,501,762893,1112657
3100,2679465,374310,89,0,Low Volume,Growth,578,374310,0
3101,963530,76470,93,1,Low Volume,Growth,547,76470,0
3102,988822,431858,82,1,High Volume,Growth,612,296646,135212
3103,4878497,2150487,96,0,Stable,Declining,542,975699,1174788
3104,765642,200931,97,0,Stable,Growth,643,200931,0
3105,7378924,2076379,93,0,Low Volume,Stable,567,1475784,600595
3106,964633,411043,93,1,Unstable,Growth,517,192926,218117
3107,3304228,1263377,95,0,Stable,Declining,539,660845,602532
3108,1524391,258105,97,0,Stable,Growth,645,258105,0
3109,3212468,185045,88,0,Low Volume,Declining,473,185045,0
3110,1282996,341104,89,0,High Volume,Stable,611,341104,0
3111,1740644,759809,99,0,Low Volume,Stable,583,348128,411681
3112,2048740,928337,95,0,High Volume,Stable,617,614622,313715
3113,889353,427158,87,0,Stable,Stable,564,177870,249288
3114,3586400,1598830,90,0,Unstable,Stable,513,717280,881550
3115,1315108,409024,94,0,Stable,Stable,570,263021,146003
3116,1651377,412964,89,0,High Volume,Declining,579,330275,82689
3117,894948,356800,85,1,Low Volume,Growth,528,178989,177811
3118,500000,191460,91,0,Stable,Stable,555,100000,91460
3119,1701767,497196,91,0,High Volume,Declining,558,340353,156843
3120,13661502,1219935,92,0,High Volume,Growth,671,1219935,0
3121,3714236,1733570,94,0,High Volume,Stable,646,1114270,619300
3122,1952442,497914,98,0,High Volume,Growth,690,497914,0
3123,1606691,343029,97,0,Stable,Growth,625,343029,0
3124,2018717,672849,96,1,Stable,Growth,599,403743,269106
3125,3071557,1084957,94,0,Low Volume,Growth,597,614311,470646
3126,770928,111638,96,0,Stable,Declining,530,111638,0
3127,4835318,2062855,82,1,High Volume,Growth,597,967063,1095792
3128,3514139,634203,90,0,High Volume,Growth,659,634203,0
3129,3522032,471980,86,1,High Volume,Stable,557,471980,0
3130,2815867,655759,82,0,Unstable,Growth,529,563173,92586
3131,2014121,762852,82,1,High Volume,Stable,568,402824,360028
3132,3396612,1645510,88,0,Stable,Stable,582,679322,966188
3133,3183371,1318478,96,0,Low Volume,Growth,628,955011,363467
3134,1493701,706755,93,1,Unstable,Declining,449,298740,408015
3135,1253084,141940,90,1,High Volume,Stable,587,141940,0
3136,2151090,176453,94,1,High Volume,Growth,643,176453,0
3137,6846281,2060506,83,0,High Volume,Declining,546,1369256,691250
3138,735801,132911,93,0,High Volume,Growth,673,132911,0
3139,612914,259033,87,0,Stable,Stable,557,122582,136451
3140,2262110,797155,86,0,Stable,Stable,539,452422,344733
3141,2065143,1005369,93,0,Low Volume,Growth,587,413028,592341
3142,2277692,375037,96,0,Stable,Growth,630,375037,0
3143,2410061,647349,93,0,Stable,Stable,579,482012,165337
3144,1658523,457020,92,0,High Volume,Stable,619,457020,0
3145,6529825,1029293,92,0,Low Volume,Growth,616,1029293,0
3146,550883,173827,96,0,Low Volume,Growth,602,165264,8563
3147,1021929,254950,87,0,Stable,Growth,592,204385,50565
3148,1825558,458260,94,0,High Volume,Growth,688,458260,0
3149,532559,113558,86,0,Unstable,Stable,511,106511,7047
3150,1722550,99250,84,0,Low Volume,Growth,572,99250,0
3151,7490725,2134429,81,1,High Volume,Growth,619,2134429,0
3152,2016168,404971,92,0,Stable,Stable,568,403233,1738
3153,2384645,120649,94,1,High Volume,Growth,628,120649,0
3154,723509,136435,82,0,High Volume,Declining,560,136435,0
3155,1210944,212379,90,2,High Volume,Stable,543,212379,0
3156,1468633,333456,94,1,Stable,Growth,572,293726,39730
3157,1537745,168127,92,1,High Volume,Growth,636,168127,0
3158,5527881,1539281,88,0,Stable,Growth,634,1539281,0
3159,3097645,1120103,80,0,High Volume,Growth,639,929293,190810
3160,814911,271841,91,0,High Volume,Growth,671,244473,27368
3161,2414985,994225,79,1,Low Volume,Growth,517,482997,511228
3162,2953724,748485,89,1,Stable,Growth,574,590744,157741
3163,4936264,1399881,86,1,Stable,Growth,586,987252,412629
3164,7021115,2911522,89,0,High Volume,Stable,621,2106334,805188
3165,880218,213423,86,1,Low Volume,Declining,437,176043,37380
3166,1036452,379051,95,0,Unstable,Growth,591,207290,171761
3167,725008,178041,79,0,Stable,Growth,597,145001,33040
3168,1644232,391296,94,0,High Volume,Declining,582,328846,62450
3169,2879383,1128985,84,1,Stable,Growth,557,575876,553109
3170,4368226,562089,98,0,High Volume,Growth,680,562089,0
3171,1865872,377585,84,0,High Volume,Growth,672,377585,0
3172,1535124,231616,93,0,Stable,Declining,548,231616,0
3173,2238701,473708,89,0,High Volume,Growth,678,473708,0
3174,1016510,156206,93,0,Unstable,Declining,455,156206,0
3175,10549943,3278211,96,0,Low Volume,Growth,627,3164982,113229
3176,547913,224193,92,0,High Volume,Stable,617,164373,59820
3177,2298558,928562,82,0,Unstable,Stable,499,459711,468851
3178,10007896,2141944,98,0,Stable,Stable,591,2001579,140365
3179,1993575,986704,92,0,Stable,Growth,618,598072,388632
3180,1703114,540286,94,0,Stable,Growth,612,510934,29352
3181,1489638,342215,93,0,Stable,Growth,642,342215,0
3182,1716309,731135,88,0,High Volume,Growth,644,514892,216243
3183,5946294,2250335,81,0,Unstable,Stable,487,1189258,1061077
3184,500000,193587,94,0,High Volume,Stable,620,150000,43587
3185,6761444,934856,93,0,Stable,Growth,629,934856,0
3186,634653,165483,91,0,Low Volume,Stable,529,126930,38553
3187,1601863,701332,92,1,Low Volume,Growth,554,320372,380960
3188,1406485,389339,93,0,Stable,Growth,639,389339,0
3189,3175078,1135261,98,0,Low Volume,Declining,526,635015,500246
3190,552109,173677,88,0,High Volume,Growth,671,165632,8045
3191,2869758,1231300,92,0,Low Volume,Growth,596,573951,657349
3192,10013530,1782933,95,0,Low Volume,Growth,622,1782933,0
3193,666277,205856,94,0,Stable,Declining,514,133255,72601
3194,2307707,243361,84,0,Stable,Growth,602,243361,0
3195,1167546,421011,90,0,Stable,Stable,560,233509,187502
3196,2787651,1057594,89,0,High Volume,Stable,635,836295,221299
3197,2013365,139479,96,1,Stable,Declining,504,139479,0
3198,1186847,420270,99,1,Unstable,Growth,561,237369,182901
3199,2929370,693120,91,1,Stable,Growth,583,585874,107246
3200,8397785,888852,97,0,Stable,Declining,551,888852,0
3201,1701936,406692,93,0,Unstable,Growth,556,340387,66305
3202,3526464,484553,88,0,Stable,Growth,625,484553,0
3203,704597,166991,100,0,Stable,Stable,602,166991,0
3204,922508,205676,100,1,Low Volume,Stable,546,184501,21175
3205,2893348,1106058,83,1,Stable,Growth,541,578669,527389
3206,6499871,2589529,85,0,Unstable,Declining,434,1299974,1289555
3207,2635255,851617,95,0,Low Volume,Declining,507,527051,324566
3208,1543485,92932,94,0,Unstable,Growth,590,92932,0
3209,1981636,929308,88,0,High Volume,Growth,648,594490,334818
3210,729178,261633,87,1,Stable,Growth,590,145835,115798
3211,3215882,210280,92,0,Stable,Declining,508,210280,0
3212,4016279,1680712,92,1,Stable,Stable,553,803255,877457
3213,1381013,193507,94,0,Stable,Growth,615,193507,0
3214,1361321,422894,90,0,Low Volume,Stable,530,272264,150630
3215,2452706,637668,91,0,Stable,Declining,513,490541,147127
3216,1398099,334044,91,1,Stable,Stable,531,279619,54425
3217,1880586,846962,85,0,Stable,Growth,588,376117,470845
3218,10636238,2625157,97,0,Low Volume,Growth,622,2625157,0
3219,1627213,136531,91,0,Stable,Growth,633,136531,0
3220,1488572,708542,95,0,Low Volume,Growth,620,446571,261971
3221,1181112,548320,97,0,Unstable,Growth,578,236222,312098
3222,3596075,1287376,82,0,High Volume,Growth,658,1078822,208554
3223,1715166,446889,90,1,Unstable,Growth,502,343033,103856
3224,1179383,108252,93,0,High Volume,Stable,614,108252,0
3225,5706082,2315737,94,1,Stable,Growth,581,1141216,1174521
3226,6172919,518310,98,0,Unstable,Growth,582,518310,0
3227,1226483,99186,95,0,Stable,Declining,515,99186,0
3228,500000,145911,98,1,High Volume,Stable,618,145911,0
3229,4439316,541853,95,1,Stable,Growth,587,541853,0
3230,1146582,61318,84,1,Low Volume,Declining,444,61318,0
3231,3732170,897218,88,1,Stable,Growth,573,746434,150784
3232,500000,55874,96,0,Low Volume,Growth,596,55874,0
3233,4049394,494965,88,2,Low Volume,Growth,493,494965,0
3234,752429,63663,93,0,Unstable,Stable,532,63663,0
3235,3557652,506226,88,0,High Volume,Declining,562,506226,0
3236,2005529,745992,83,0,Stable,Growth,593,401105,344887
3237,924352,382698,95,0,Stable,Growth,652,277305,105393
3238,1431697,363136,95,0,Stable,Growth,651,363136,0
3239,3433377,954304,97,0,High Volume,Stable,644,954304,0
3240,2158050,139615,98,0,High Volume,Declining,610,139615,0
3241,3164578,256939,89,1,Unstable,Growth,517,256939,0
3242,9637309,1598882,83,0,Stable,Growth,611,1598882,0
3243,567279,167208,94,1,High Volume,Growth,652,167208,0
3244,7230148,2767686,91,0,Stable,Growth,624,2169044,598642
3245,2155395,694579,98,0,Stable,Growth,650,646618,47961
3246,966052,218770,91,0,Stable,Stable,571,193210,25560
3247,684025,70623,89,0,Stable,Growth,607,70623,0
3248,1704366,684044,95,1,Stable,Stable,537,340873,343171
3249,4144613,885719,85,0,High Volume,Growth,641,885719,0
3250,1790420,682552,89,0,Stable,Growth,623,537126,145426
3251,6642002,1865343,88,0,Low Volume,Growth,587,1328400,536943
3252,620983,237463,85,0,Stable,Growth,609,186294,51169
3253,1963676,899914,93,0,Unstable,Growth,571,392735,507179
3254,728021,338139,89,0,Stable,Growth,633,218406,119733
3255,2652214,771259,85,0,High Volume,Declining,556,530442,240817
3256,4030939,1129384,90,0,High Volume,Growth,671,1129384,0
3257,1416062,240101,92,1,Stable,Growth,568,240101,0
3258,500000,235555,88,0,Stable,Growth,604,150000,85555
3259,2324832,595305,88,0,High Volume,Growth,667,595305,0
3260,2811956,302049,88,1,Stable,Growth,578,302049,0
3261,2739910,670503,97,0,High Volume,Growth,688,670503,0
3262,5328742,571102,91,1,High Volume,Growth,640,571102,0
3263,841682,232421,92,0,Stable,Declining,544,168336,64085
3264,3416656,1033791,91,1,Unstable,Stable,462,683331,350460
3265,5147419,1039728,95,0,High Volume,Stable,648,1039728,0
3266,500000,41121,92,0,High Volume,Growth,681,41121,0
3267,2560521,1215163,95,2,Stable,Stable,520,512104,703059
3268,1324646,527221,82,0,High Volume,Growth,649,397393,129828
3269,1857574,794106,96,1,High Volume,Stable,597,371514,422592
3270,2618576,563232,95,0,Unstable,Growth,587,523715,39517
3271,1342732,526853,91,0,Low Volume,Growth,608,402819,124034
3272,1154795,309968,84,0,Low Volume,Stable,524,230959,79009
3273,2037679,286269,86,0,High Volume,Stable,612,286269,0
3274,830849,88062,98,1,High Volume,Stable,591,88062,0
3275,831794,170745,82,0,Stable,Growth,581,166358,4387
3276,3414353,382061,97,1,Low Volume,Growth,582,382061,0
3277,790930,394849,95,0,Stable,Growth,622,237279,157570
3278,3378864,243735,87,1,High Volume,Growth,633,243735,0
3279,2870719,713416,99,0,Stable,Stable,578,574143,139273
3280,500000,126721,90,3,High Volume,Growth,532,100000,26721
3281,1153081,213648,98,0,Unstable,Stable,515,213648,0
3282,5154020,1582842,92,0,Stable,Growth,615,1546206,36636
3283,904437,106262,86,0,Stable,Growth,592,106262,0
3284,1367475,550765,89,0,Unstable,Stable,519,273495,277270
3285,2869501,572757,87,0,Unstable,Growth,552,572757,0
3286,3710631,1172946,95,1,Stable,Declining,478,742126,430820
3287,1621349,603203,89,0,Stable,Growth,615,486404,116799
3288,1229345,553290,88,1,Stable,Growth,563,245869,307421
3289,6186598,2636136,83,0,Stable,Growth,581,1237319,1398817
3290,7969400,2580006,99,0,Stable,Growth,634,2390820,189186
3291,4338705,975241,97,0,Low Volume,Stable,558,867741,107500
3292,2122817,586836,88,1,Stable,Declining,455,424563,162273
3293,1038603,411215,91,0,Stable,Growth,641,311580,99635
3294,1020338,453944,88,0,Stable,Growth,603,306101,147843
3295,3011688,291236,92,0,Low Volume,Declining,495,291236,0
3296,2770999,618446,79,0,Low Volume,Stable,516,554199,64247
3297,6084645,2429310,94,0,Stable,Growth,618,1825393,603917
3298,3336257,814858,94,0,Unstable,Growth,576,667251,147607
3299,595726,118849,93,0,High Volume,Stable,622,118849,0
3300,4599960,1081429,92,0,Stable,Stable,565,919992,161437
3301,892294,286676,91,0,Unstable,Stable,506,178458,108218
3302,1458360,729052,85,1,Stable,Declining,477,291672,437380
3303,2422136,658449,91,1,Low Volume,Growth,541,484427,174022
3304,9786691,1407547,97,0,High Volume,Growth,689,1407547,0
3305,23865271,2942133,96,0,Stable,Growth,655,2942133,0
3306,3221567,222473,82,0,Unstable,Growth,536,222473,0
3307,1712462,516252,95,0,High Volume,Stable,645,513738,2514
3308,3040719,897187,88,0,Stable,Growth,596,608143,289044
3309,4033416,574178,88,0,Stable,Growth,597,574178,0
3310,1534118,556729,92,1,Stable,Declining,497,306823,249906
3311,8336626,3197081,92,1,Stable,Growth,578,1667325,1529756
3312,2383443,397068,89,0,High Volume,Stable,614,397068,0
3313,2952593,604824,82,0,Stable,Stable,535,590518,14306
3314,3377814,1674424,97,1,Stable,Growth,597,675562,998862
3315,2778076,606785,88,0,Stable,Growth,617,606785,0
3316,3879250,1522065,95,0,High Volume,Growth,683,1163775,358290
3317,1210081,307030,94,1,Stable,Declining,504,242016,65014
3318,1268516,516293,96,0,Low Volume,Stable,543,253703,262590
3319,822313,325686,90,1,Stable,Growth,593,164462,161224
3320,2818178,987744,93,0,Low Volume,Growth,618,845453,142291
3321,3697432,1607090,82,0,Unstable,Growth,551,739486,867604
3322,2859674,1351620,93,1,Low Volume,Growth,557,571934,779686
3323,7569170,2353955,84,1,Unstable,Growth,517,1513834,840121
3324,1973903,309628,94,0,High Volume,Declining,562,309628,0
3325,3385436,776562,90,0,Stable,Stable,562,677087,99475
3326,827893,323903,93,0,High Volume,Growth,683,248367,75536
3327,1454715,498818,96,0,Low Volume,Stable,549,290943,207875
3328,3458793,449675,92,0,Low Volume,Declining,504,449675,0
3329,3910914,285723,94,1,High Volume,Declining,548,285723,0
3330,1567240,560026,91,0,Stable,Growth,628,470172,89854
3331,1872379,305171,91,0,Low Volume,Growth,580,305171,0
3332,588717,161810,90,0,Stable,Growth,623,161810,0
3333,1490134,575245,97,0,Stable,Stable,590,298026,277219
3334,4042228,1225604,84,0,High Volume,Growth,651,1212668,12936
3335,3141353,274825,95,0,Low Volume,Declining,485,274825,0
3336,2959505,395127,83,1,High Volume,Stable,562,395127,0
3337,2063304,306809,93,1,Stable,Growth,592,306809,0
3338,1993995,331081,90,0,Unstable,Growth,562,331081,0
3339,1169098,355910,82,0,Stable,Growth,609,350729,5181
3340,3467910,959864,83,0,Low Volume,Growth,557,693582,266282
3341,2776713,392688,89,0,Low Volume,Declining,498,392688,0
3342,2939103,236303,92,1,High Volume,Stable,568,236303,0
3343,1301688,165502,89,0,Unstable,Stable,524,165502,0
3344,500000,246486,91,0,High Volume,Growth,685,150000,96486
3345,4769358,1244069,85,1,High Volume,Declining,507,953871,290198
3346,1351776,595194,95,0,Low Volume,Growth,622,405532,189662
3347,994285,429470,96,2,Stable,Declining,446,198857,230613
3348,3453101,967503,97,1,Stable,Growth,581,690620,276883
3349,1449008,533249,92,0,High Volume,Stable,618,434702,98547
3350,4629452,633024,94,0,Stable,Stable,598,633024,0
3351,3248178,1168625,95,1,Unstable,Growth,535,649635,518990
3352,3425834,591207,98,0,High Volume,Declining,584,591207,0
3353,664796,282158,83,0,Low Volume,Declining,485,132959,149199
3354,5228083,458377,89,0,Stable,Growth,609,458377,0
3355,2443643,972356,94,1,Stable,Growth,605,733092,239264
3356,1475604,140140,100,0,Stable,Stable,580,140140,0
3357,2223762,992988,89,1,Stable,Stable,511,444752,548236
3358,500000,93446,81,0,High Volume,Growth,662,93446,0
3359,2749480,947133,90,1,High Volume,Stable,578,549896,397237
3360,870221,234417,81,0,Stable,Growth,593,174044,60373
3361,671899,144348,94,0,Unstable,Declining,483,134379,9969
3362,586608,199710,89,0,Unstable,Stable,491,117321,82389
3363,4829004,2300467,88,1,High Volume,Growth,607,1448701,851766
3364,1198510,82183,94,0,Low Volume,Declining,515,82183,0
3365,6763034,3134557,85,0,High Volume,Growth,636,2028910,1105647
3366,1291557,418577,89,0,Unstable,Stable,490,258311,160266
3367,505910,209088,90,0,Low Volume,Stable,542,101182,107906
3368,811614,180782,93,0,Unstable,Stable,513,162322,18460
3369,5328867,1397918,94,0,Stable,Declining,546,1065773,332145
3370,1750271,771839,91,1,Low Volume,Stable,519,350054,421785
3371,1278720,302649,92,0,Low Volume,Declining,477,255744,46905
3372,2253544,654873,93,0,Stable,Declining,537,450708,204165
3373,2962151,175027,89,0,Unstable,Stable,500,175027,0
3374,4847235,588305,95,0,High Volume,Growth,686,588305,0
3375,6317281,2140035,90,0,Unstable,Growth,562,1263456,876579
3376,1486872,554067,88,1,Low Volume,Growth,547,297374,256693
3377,686363,214262,84,0,Stable,Stable,551,137272,76990
3378,1424352,163073,83,0,High Volume,Growth,658,163073,0
3379,2441747,611493,96,0,High Volume,Growth,686,611493,0
3380,917119,192405,95,0,Low Volume,Declining,487,183423,8982
3381,921980,251744,94,0,Low Volume,Declining,515,184396,67348
3382,2610443,1152897,86,1,Unstable,Growth,499,522088,630809
3383,1907069,761183,84,0,Stable,Declining,515,381413,379770
3384,2035471,178705,89,0,Low Volume,Growth,571,178705,0
3385,1080791,487047,93,1,Low Volume,Growth,545,216158,270889
3386,1649000,432525,96,1,Unstable,Declining,432,329800,102725
3387,946583,364186,96,0,High Volume,Stable,642,283974,80212
3388,4041630,456776,95,0,Stable,Stable,582,456776,0
3389,4538919,1596900,90,0,High Volume,Declining,573,907783,689117
3390,500000,78173,92,1,Stable,Growth,589,78173,0
3391,942594,233077,91,1,Low Volume,Stable,513,188518,44559
3392,598856,34487,89,0,High Volume,Growth,685,34487,0
3393,1178769,139360,88,1,High Volume,Declining,513,139360,0
3394,1854730,169590,95,0,Stable,Growth,618,169590,0
3395,621744,98164,89,0,Stable,Stable,553,98164,0
3396,948382,90104,96,1,Stable,Declining,503,90104,0
3397,888095,320922,96,0,Stable,Growth,622,266428,54494
3398,2340357,147602,98,1,Stable,Growth,613,147602,0
3399,2095862,687408,89,0,High Volume,Stable,599,419172,268236
3400,1113045,126129,89,1,Stable,Stable,514,126129,0
3401,2284041,1085656,89,0,High Volume,Declining,566,456808,628848
3402,1280365,601634,94,0,High Volume,Growth,693,384109,217525
3403,1595465,241675,86,1,Low Volume,Declining,434,241675,0
3404,7562873,2469199,98,0,Low Volume,Stable,581,1512574,956625
3405,5794205,362731,87,0,High Volume,Growth,679,362731,0
3406,701050,329006,85,0,High Volume,Growth,658,210315,118691
3407,3850779,1098798,82,0,High Volume,Growth,650,1098798,0
3408,3794705,263544,97,0,Stable,Growth,660,263544,0
3409,791266,161517,86,0,Stable,Stable,548,158253,3264
3410,3817179,322866,88,1,Low Volume,Growth,549,322866,0
3411,6785819,1539193,96,0,High Volume,Stable,626,1539193,0
3412,807715,283885,90,0,Stable,Declining,503,161543,122342
3413,951693,248821,91,0,Stable,Growth,626,248821,0
3414,4475502,996582,94,3,Low Volume,Growth,473,895100,101482
3415,2463753,255296,98,1,High Volume,Growth,672,255296,0
3416,3082283,493851,90,0,High Volume,Stable,640,493851,0
3417,2603771,247526,90,0,Stable,Declining,531,247526,0
3418,2710264,1120354,83,1,Stable,Stable,529,542052,578302
3419,686130,76063,92,0,Low Volume,Growth,582,76063,0
3420,4582953,1457003,81,0,High Volume,Growth,645,1374885,82118
3421,5053906,1032175,94,0,High Volume,Growth,677,1032175,0
3422,1650333,250339,88,0,Stable,Stable,547,250339,0
3423,1914981,646806,90,0,High Volume,Stable,601,574494,72312
3424,582517,148921,93,0,Unstable,Declining,481,116503,32418
3425,2991854,688322,97,0,Stable,Stable,585,598370,89952
3426,3133452,992626,97,1,High Volume,Stable,599,626690,365936
3427,1886525,511381,80,1,Stable,Growth,557,377305,134076
3428,4874279,909384,83,0,Low Volume,Growth,575,909384,0
3429,1517748,457719,96,0,Stable,Growth,641,455324,2395
3430,3114829,1094160,89,0,Stable,Growth,618,934448,159712
3431,877005,54385,92,0,Low Volume,Growth,612,54385,0
3432,1945750,505199,88,0,Low Volume,Declining,492,389150,116049
3433,1724619,130998,94,0,High Volume,Stable,642,130998,0
3434,2374379,317888,94,0,High Volume,Growth,699,317888,0
3435,1475310,445881,100,1,Unstable,Growth,564,295062,150819
3436,1784809,784932,86,0,High Volume,Growth,659,535442,249490
3437,3839443,1717239,85,1,Stable,Growth,583,767888,949351
3438,1398050,113906,93,0,Unstable,Growth,585,113906,0
3439,548388,130844,92,1,Stable,Growth,585,109677,21167
3440,8037809,2510633,92,1,Stable,Growth,582,1607561,903072
3441,5987373,695622,83,1,Low Volume,Stable,481,695622,0
3442,705167,278149,95,0,Stable,Declining,534,141033,137116
3443,3442699,1325115,94,0,Stable,Growth,647,1032809,292306
3444,1325924,605289,99,1,Stable,Declining,505,265184,340105
3445,2448019,131749,87,1,High Volume,Growth,604,131749,0
3446,2508961,370092,89,0,Stable,Stable,569,370092,0
3447,1643722,694035,92,1,Low Volume,Growth,546,328744,365291
3448,1059161,372572,88,0,Low Volume,Growth,564,211832,160740
3449,1141173,516353,96,0,Stable,Growth,620,342351,174002
3450,952692,72148,92,0,Stable,Growth,624,72148,0
3451,1019214,324756,83,0,Unstable,Declining,425,203842,120914
3452,1879013,575111,92,0,Stable,Growth,642,563703,11408
3453,1118380,73873,87,0,Low Volume,Growth,577,73873,0
3454,3421678,961782,91,0,Low Volume,Growth,582,684335,277447
3455,6516167,2113090,78,0,High Volume,Stable,599,1303233,809857
3456,1246634,169644,90,0,High Volume,Stable,637,169644,0
3457,2401307,415422,88,0,Stable,Declining,530,415422,0
3458,2957184,999990,91,1,Low Volume,Stable,523,591436,408554
3459,2892413,754155,94,1,Stable,Growth,578,578482,175673
3460,2106976,918865,91,0,Low Volume,Growth,581,421395,497470
3461,3591735,732972,91,0,Low Volume,Growth,601,732972,0
3462,2916221,495748,93,0,Stable,Declining,530,495748,0
3463,736651,363309,92,1,Stable,Stable,552,147330,215979
3464,3974164,1828160,89,0,High Volume,Stable,626,1192249,635911
3465,4032240,254220,94,1,Unstable,Growth,544,254220,0
3466,1076657,427248,92,0,Stable,Growth,627,322997,104251
3467,2043859,203672,93,0,High Volume,Stable,624,203672,0
3468,3425175,213622,95,0,High Volume,Stable,617,213622,0
3469,1677054,290404,83,1,High Volume,Stable,548,290404,0
3470,4678006,800901,95,0,High Volume,Stable,654,800901,0
3471,13139033,5501227,91,0,Stable,Growth,619,3941709,1559518
3472,1057281,390983,89,0,Stable,Stable,557,211456,179527
3473,656819,322974,92,1,Stable,Growth,593,131363,191611
3474,2528293,935926,93,0,Low Volume,Stable,545,505658,430268
3475,3531559,841270,83,0,High Volume,Growth,661,841270,0
3476,1648386,600865,96,0,Low Volume,Stable,567,329677,271188
3477,6341390,3169151,84,0,Low Volume,Growth,574,1268278,1900873
3478,679502,251119,97,1,Stable,Declining,518,135900,115219
3479,3451553,1355620,82,0,High Volume,Stable,581,690310,665310
3480,1221159,576710,91,1,Stable,Stable,529,244231,332479
3481,7845905,793559,91,0,Low Volume,Growth,585,793559,0
3482,9762043,3584163,96,0,Unstable,Growth,576,1952408,1631755
3483,1073757,464789,93,0,High Volume,Stable,626,322127,142662
3484,1277422,612486,89,0,Stable,Declining,529,255484,357002
3485,3943859,571608,94,1,Stable,Stable,523,571608,0
3486,1454679,402609,97,0,High Volume,Growth,695,402609,0
3487,1912020,681157,89,1,High Volume,Growth,629,573606,107551
3488,2023442,326504,93,0,High Volume,Growth,669,326504,0
3489,500000,160106,93,0,High Volume,Stable,613,150000,10106
3490,1960931,325339,90,0,High Volume,Growth,690,325339,0
3491,1141916,228447,92,2,Stable,Declining,441,228383,64
3492,1336416,332344,99,0,Stable,Growth,637,332344,0
3493,6292730,1813159,94,0,Low Volume,Stable,535,1258546,554613
3494,725629,183014,96,0,Stable,Stable,596,145125,37889
3495,3800200,1033419,88,0,High Volume,Stable,602,1033419,0
3496,1586165,292433,86,0,High Volume,Stable,605,292433,0
3497,1585154,192651,92,0,Low Volume,Growth,593,192651,0
3498,3731413,266078,97,0,Low Volume,Stable,578,266078,0
3499,2602651,359661,92,0,High Volume,Stable,632,359661,0
3500,3129834,976116,89,0,High Volume,Stable,602,938950,37166
3501,4301816,1736867,88,1,Low Volume,Growth,559,860363,876504
3502,1521114,191906,88,0,Stable,Stable,570,191906,0
3503,1214947,120097,95,0,Stable,Growth,625,120097,0
3504,832243,322228,93,0,Stable,Growth,646,249672,72556
3505,1024455,191902,93,0,Low Volume,Growth,587,191902,0
3506,20984099,10034066,88,0,High Volume,Stable,606,6295229,3738837
3507,5366807,1993463,94,0,Stable,Growth,629,1610042,383421
3508,672758,132560,96,0,High Volume,Growth,685,132560,0
3509,688337,124103,89,1,Stable,Growth,557,124103,0
3510,2915328,832805,93,0,Unstable,Growth,577,583065,249740
3511,3071915,263002,96,1,High Volume,Stable,600,263002,0
3512,3075897,316677,91,1,Unstable,Growth,539,316677,0
3513,1616923,208803,91,1,Low Volume,Declining,464,208803,0
3514,1793423,714904,95,0,High Volume,Growth,691,538026,176878
3515,2577431,724866,87,0,Stable,Stable,558,515486,209380
3516,2123793,116289,91,0,Stable,Growth,618,116289,0
3517,500000,176541,96,0,High Volume,Stable,655,150000,26541
3518,1649793,397040,87,1,High Volume,Growth,625,397040,0
3519,1003370,280827,89,0,High Volume,Growth,647,280827,0
3520,2281102,333845,87,0,Low Volume,Declining,461,333845,0
3521,21600072,6443345,94,1,Low Volume,Declining,474,4320014,2123331
3522,2660395,1305240,94,1,Stable,Growth,581,532079,773161
3523,1542903,128138,88,0,Stable,Stable,549,128138,0
3524,4145115,736847,89,0,Stable,Stable,587,736847,0
3525,2917245,464860,88,0,Low Volume,Growth,587,464860,0
3526,2774762,449087,87,0,Stable,Declining,496,449087,0
3527,3221896,710163,95,1,High Volume,Growth,633,710163,0
3528,10275108,4296530,88,0,Stable,Declining,526,2055021,2241509
3529,802341,369708,93,0,Stable,Stable,573,160468,209240
3530,2896187,408353,98,0,Low Volume,Stable,581,408353,0
3531,944957,278127,92,0,High Volume,Stable,641,278127,0
3532,3092252,1040866,93,1,Stable,Stable,526,618450,422416
3533,950792,270807,99,1,High Volume,Stable,612,270807,0
3534,1419914,348354,93,1,Low Volume,Declining,445,283982,64372
3535,1565832,213562,87,1,Stable,Growth,560,213562,0
3536,4328161,1167299,86,0,Stable,Growth,605,1167299,0
3537,4134031,953087,96,0,Low Volume,Declining,513,826806,126281
3538,731920,298626,95,1,Stable,Stable,528,146384,152242
3539,2071839,815521,97,0,High Volume,Growth,711,815521,0
3540,1123923,123968,83,0,Low Volume,Stable,506,123968,0
3541,724470,65082,86,0,Low Volume,Declining,482,65082,0
3542,1666750,764487,94,0,High Volume,Stable,629,500025,264462
3543,1549145,450768,87,0,Unstable,Stable,485,309829,140939
3544,13816488,6024133,92,0,High Volume,Growth,659,4144946,1879187
3545,2803468,213535,87,1,Stable,Declining,458,213535,0
3546,658623,188980,98,0,High Volume,Stable,625,188980,0
3547,1261965,369430,89,0,Unstable,Growth,539,252393,117037
3548,4488848,1963045,96,0,High Volume,Declining,597,897769,1065276
3549,10540697,990030,87,1,Unstable,Stable,447,990030,0
3550,557498,88196,85,1,Stable,Growth,568,88196,0
3551,500000,116471,95,1,High Volume,Growth,631,116471,0
3552,8857474,3893999,93,0,Stable,Declining,544,1771494,2122505
3553,2707920,1279485,98,0,Low Volume,Growth,594,541584,737901
3554,989907,491713,91,0,Stable,Growth,632,296972,194741
3555,3041019,1464667,91,0,High Volume,Growth,686,912305,552362
3556,500000,26337,99,0,High Volume,Stable,632,26337,0
3557,1988121,142089,93,0,High Volume,Growth,659,142089,0
3558,2577310,300058,100,0,High Volume,Growth,705,300058,0
3559,4153310,859685,97,0,Stable,Stable,609,859685,0
3560,881062,373097,87,1,Stable,Growth,581,176212,196885
3561,2123444,959150,91,0,Stable,Stable,592,424688,534462
3562,945681,126793,89,0,Stable,Declining,536,126793,0
3563,2432201,799827,85,0,Stable,Declining,486,486440,313387
3564,968712,448332,98,0,Unstable,Growth,574,193742,254590
3565,1430478,370035,94,0,Stable,Growth,652,370035,0
3566,893899,86346,94,0,Low Volume,Growth,619,86346,0
3567,3338089,854605,88,0,Stable,Declining,523,667617,186988
3568,3940274,863344,92,0,High Volume,Growth,678,863344,0
3569,1643442,509378,92,0,Low Volume,Growth,591,328688,180690
3570,2044350,505765,97,0,Low Volume,Stable,567,408870,96895
3571,622268,35971,92,0,Stable,Declining,541,35971,0
3572,1560097,775835,93,0,Stable,Growth,631,468029,307806
3573,1904702,561112,97,0,High Volume,Growth,703,561112,0
3574,16137148,4246230,87,0,High Volume,Declining,562,3227429,1018801
3575,814579,390654,96,0,Low Volume,Growth,626,244373,146281
3576,6397013,768519,79,0,Unstable,Stable,472,768519,0
3577,4401637,594912,98,0,Stable,Declining,527,594912,0
3578,2481836,1026504,97,0,Stable,Growth,635,744550,281954
3579,8096127,1355081,88,0,Low Volume,Stable,530,1355081,0
3580,2670255,1093876,96,1,Low Volume,Declining,478,534051,559825
3581,2706934,466107,94,0,Stable,Stable,600,466107,0
3582,1900264,123393,93,0,Stable,Growth,639,123393,0
3583,5276930,1491559,97,0,Stable,Stable,605,1491559,0
3584,4766750,660237,88,0,High Volume,Growth,665,660237,0
3585,1201953,470001,88,0,Stable,Growth,615,360585,109416
3586,690107,233629,85,0,Stable,Stable,537,138021,95608
3587,1685572,784838,92,1,Stable,Growth,583,337114,447724
3588,1045462,420636,89,0,High Volume,Growth,672,313638,106998
3589,1884514,247529,85,1,Stable,Growth,579,247529,0
3590,5335806,2188060,98,0,High Volume,Growth,697,1600741,587319
3591,1375267,465915,90,0,Low Volume,Growth,595,275053,190862
3592,1915983,672564,99,0,High Volume,Growth,712,672564,0
3593,2076965,881710,99,0,Low Volume,Declining,517,415393,466317
3594,3908815,1204778,96,1,Low Volume,Stable,504,781763,423015
3595,500000,129851,95,0,Unstable,Growth,559,100000,29851
3596,1220340,410630,85,0,Stable,Stable,565,244068,166562
3597,2347888,432201,82,0,High Volume,Declining,540,432201,0
3598,5178692,684461,77,1,Stable,Declining,422,684461,0
3599,1337721,438056,83,0,High Volume,Growth,646,401316,36740
3600,500000,77616,90,0,High Volume,Stable,609,77616,0
3601,3255216,279824,97,1,Low Volume,Growth,552,279824,0
3602,1192676,59931,96,0,High Volume,Growth,677,59931,0
3603,765486,247821,94,0,Stable,Growth,651,229645,18176
3604,1203234,256249,95,0,Low Volume,Stable,546,240646,15603
3605,1710643,664653,88,0,High Volume,Growth,665,513192,151461
3606,1222250,267464,90,1,Low Volume,Growth,570,244450,23014
3607,500000,134351,90,0,Stable,Growth,620,134351,0
3608,4063897,947653,86,0,Stable,Stable,565,812779,134874
3609,5498028,1884497,98,1,High Volume,Stable,586,1099605,784892
3610,3339119,702092,88,0,Stable,Stable,580,667823,34269
3611,797990,385984,98,0,Stable,Growth,651,239397,146587
3612,1687581,795300,88,0,Unstable,Growth,538,337516,457784
3613,1972442,851331,86,0,Stable,Growth,592,394488,456843
3614,3201197,1485788,88,0,Low Volume,Declining,472,640239,845549
3615,3384350,853238,90,0,High Volume,Growth,673,853238,0
3616,1102026,321123,81,1,Low Volume,Growth,539,220405,100718
3617,2117182,812874,97,0,Stable,Stable,601,635154,177720
3618,2858548,1038412,96,0,Stable,Growth,631,857564,180848
3619,6354399,2864597,95,0,Low Volume,Growth,625,1906319,958278
3620,3483699,1297152,91,0,Unstable,Growth,569,696739,600413
3621,3727489,1860196,97,0,High Volume,Growth,691,1118246,741950
3622,2120285,438533,87,0,Low Volume,Growth,583,424057,14476
3623,6127928,2603444,93,0,Unstable,Growth,586,1225585,1377859
3624,2751922,1001523,84,1,Stable,Growth,545,550384,451139
3625,995629,359545,95,0,Stable,Growth,618,298688,60857
3626,6093273,1198096,92,0,Low Volume,Growth,580,1198096,0
3627,3465345,1398339,83,0,Unstable,Growth,531,693069,705270
3628,1391044,633160,91,0,Unstable,Stable,524,278208,354952
3629,1351068,200427,98,0,High Volume,Growth,678,200427,0
3630,2513685,833220,83,1,Low Volume,Growth,539,502737,330483
3631,2872082,650414,89,0,Stable,Growth,611,650414,0
3632,2321755,1149957,98,0,Stable,Growth,641,696526,453431
3633,2543488,675232,92,0,Low Volume,Stable,565,508697,166535
3634,7724950,1179940,93,0,Low Volume,Growth,596,1179940,0
3635,4672639,1036559,93,0,Stable,Stable,586,934527,102032
3636,2309423,794966,91,1,Stable,Growth,570,461884,333082
3637,4210317,354678,90,1,Stable,Stable,537,354678,0
3638,868029,279176,95,0,Stable,Growth,628,260408,18768
3639,2725988,1278628,87,0,Stable,Stable,545,545197,733431
3640,8431161,3647854,87,0,Low Volume,Growth,578,1686232,1961622
3641,1665379,133985,97,1,High Volume,Growth,637,133985,0
3642,1006403,500208,90,1,Low Volume,Growth,547,201280,298928
3643,1176823,428866,96,0,Stable,Growth,636,353046,75820
3644,829264,102021,90,0,High Volume,Growth,665,102021,0
3645,1058317,58829,93,1,High Volume,Growth,633,58829,0
3646,1474152,187331,99,0,Stable,Stable,608,187331,0
3647,644059,275129,86,2,Stable,Stable,459,128811,146318
3648,2007689,119935,95,0,High Volume,Growth,693,119935,0
3649,4080874,632194,96,0,Stable,Declining,556,632194,0
3650,959143,374821,96,0,Stable,Declining,543,191828,182993
3651,6685337,2097523,94,0,Unstable,Growth,572,1337067,760456
3652,2983578,1200088,97,0,High Volume,Growth,703,1193431,6657
3653,4521998,1744441,81,0,Low Volume,Declining,479,904399,840042
3654,1171426,85245,85,0,High Volume,Stable,599,85245,0
3655,3927918,1773966,80,0,High Volume,Growth,648,1178375,595591
3656,827739,125952,85,1,High Volume,Growth,613,125952,0
3657,4041789,1208602,89,1,High Volume,Stable,587,808357,400245
3658,2274956,773325,83,0,High Volume,Growth,667,682486,90839
3659,3086663,388557,89,0,High Volume,Stable,635,388557,0
3660,774153,378796,97,2,High Volume,Growth,614,232245,146551
3661,968927,261291,93,0,Low Volume,Stable,543,193785,67506
3662,3197189,242792,96,0,Stable,Stable,597,242792,0
3663,928496,438035,99,1,Stable,Declining,511,185699,252336
3664,2872132,901334,92,0,High Volume,Growth,672,861639,39695
3665,664168,242180,93,0,Stable,Stable,587,132833,109347
3666,3908012,1118978,97,0,Stable,Growth,645,1118978,0
3667,739686,314834,85,0,Unstable,Growth,527,147937,166897
3668,3084314,200203,96,0,Stable,Growth,639,200203,0
3669,3270668,558533,89,0,High Volume,Declining,582,558533,0
3670,1135499,296753,92,0,High Volume,Stable,610,296753,0
3671,3158543,266807,89,0,Stable,Growth,636,266807,0
3672,2442063,897844,86,1,Stable,Declining,454,488412,409432
3673,1288419,292662,95,1,Stable,Growth,601,292662,0
3674,884835,152812,93,1,Stable,Stable,533,152812,0
3675,500000,25760,91,1,Stable,Stable,526,25760,0
3676,2622714,980695,86,0,Low Volume,Growth,569,524542,456153
3677,567024,241107,93,1,High Volume,Growth,633,170107,71000
3678,2139912,487404,90,1,High Volume,Growth,649,487404,0
3679,1605975,488053,90,0,Low Volume,Declining,495,321195,166858
3680,3413724,520453,81,1,Stable,Stable,509,520453,0
3681,1557143,513840,80,0,Stable,Growth,574,311428,202412
3682,1523379,84489,93,1,Low Volume,Stable,510,84489,0
3683,3560803,961024,89,0,Unstable,Growth,575,712160,248864
3684,2592275,881095,80,1,Stable,Growth,550,518455,362640
3685,2553370,1182686,82,0,Low Volume,Declining,485,510674,672012
3686,2886093,639561,93,1,Stable,Growth,591,577218,62343
3687,580440,228888,88,0,High Volume,Stable,617,174132,54756
3688,3632497,1158618,98,0,Unstable,Declining,468,726499,432119
3689,3236409,1511906,92,0,Low Volume,Stable,540,647281,864625
3690,879100,201551,84,1,Low Volume,Declining,445,175820,25731
3691,1631052,315760,98,0,Stable,Growth,652,315760,0
3692,1921380,863111,90,0,Unstable,Declining,476,384276,478835
3693,1780496,128481,98,0,Stable,Growth,658,128481,0
3694,2589792,288434,94,0,Low Volume,Growth,606,288434,0
3695,6231287,542633,84,0,High Volume,Declining,535,542633,0
3696,4711012,2022906,96,0,High Volume,Stable,643,1413303,609603
3697,693998,38013,92,1,Stable,Stable,553,38013,0
3698,3261364,1427648,91,0,Stable,Growth,606,978409,449239
3699,5741015,1452882,89,0,Low Volume,Declining,502,1148203,304679
3700,2701849,139987,92,1,High Volume,Growth,617,139987,0
3701,4745865,1095062,93,2,Low Volume,Declining,414,949173,145889
3702,9917549,1329550,91,0,Low Volume,Declining,486,1329550,0
3703,4497209,1488487,99,0,Low Volume,Growth,636,1349162,139325
3704,2420408,860967,95,0,Stable,Stable,584,484081,376886
3705,4574787,1232390,97,0,Low Volume,Growth,609,1232390,0
3706,2226431,151918,96,1,Low Volume,Stable,517,151918,0
3707,2021039,697780,98,2,Stable,Growth,571,404207,293573
3708,1496843,642022,83,0,Low Volume,Growth,553,299368,342654
3709,6925568,2591173,96,0,Stable,Declining,554,1385113,1206060
3710,1030193,436267,82,0,Stable,Stable,540,206038,230229
3711,6755680,947344,93,0,High Volume,Growth,677,947344,0
3712,2957608,1330922,99,0,Low Volume,Stable,582,591521,739401
3713,647293,126214,95,0,High Volume,Growth,690,126214,0
3714,2660752,149088,84,0,High Volume,Stable,620,149088,0
3715,500000,214763,96,0,Stable,Stable,597,100000,114763
3716,3270346,1549554,91,0,High Volume,Growth,664,981103,568451
3717,4025603,1388838,95,0,Unstable,Growth,573,805120,583718
3718,1234424,190282,88,0,Unstable,Stable,492,190282,0
3719,2188743,357389,96,0,Low Volume,Stable,573,357389,0
3720,9467031,2461114,98,1,Stable,Growth,588,1893406,567708
3721,1322987,600668,95,0,High Volume,Growth,693,396896,203772
3722,849900,99709,98,0,High Volume,Growth,705,99709,0
3723,6487130,2735546,98,0,Low Volume,Growth,596,1297426,1438120
3724,9531091,1725950,86,0,High Volume,Stable,612,1725950,0
3725,1988630,823022,93,0,Low Volume,Growth,612,596589,226433
3726,4453364,2066904,94,1,Low Volume,Growth,572,890672,1176232
3727,5798911,1405495,99,1,High Volume,Growth,657,1405495,0
3728,1094724,234570,98,0,Stable,Stable,583,218944,15626
3729,1344799,552712,92,0,Stable,Declining,539,268959,283753
3730,5307862,1530083,92,0,High Volume,Stable,634,1530083,0
3731,7633152,2732684,95,0,Stable,Stable,585,1526630,1206054
3732,3110533,1027326,97,0,Low Volume,Stable,581,622106,405220
3733,980824,116522,92,0,Unstable,Growth,558,116522,0
3734,9719540,4180915,94,0,High Volume,Growth,693,2915862,1265053
3735,1296558,179053,91,0,Stable,Declining,528,179053,0
3736,1516461,712019,88,0,Stable,Declining,511,303292,408727
3737,2607416,424375,89,0,Stable,Stable,585,424375,0
3738,6874492,2614001,90,0,Stable,Growth,625,2062347,551654
3739,3926193,699235,91,0,Low Volume,Declining,496,699235,0
3740,2763179,533303,89,0,Low Volume,Growth,597,533303,0
3741,2872321,544307,87,0,Low Volume,Declining,476,544307,0
3742,2052998,793589,97,0,Low Volume,Growth,627,615899,177690
3743,3098757,931383,95,0,Stable,Growth,643,929627,1756
3744,500000,223664,89,0,Low Volume,Declining,478,100000,123664
3745,1563932,294516,85,1,High Volume,Stable,549,294516,0
3746,2404993,869156,87,0,Unstable,Growth,540,480998,388158
3747,789527,306989,97,2,Unstable,Growth,492,157905,149084
3748,2700800,319145,92,0,Low Volume,Declining,515,319145,0
3749,1683563,387666,89,0,Stable,Growth,624,387666,0
3750,8075784,2158398,98,0,Stable,Growth,624,2158398,0
3751,6978997,1466003,82,1,High Volume,Stable,561,1395799,70204
3752,1365943,266292,92,1,High Volume,Stable,599,266292,0
3753,1757372,630701,99,1,High Volume,Declining,557,351474,279227
3754,1868865,274985,81,0,High Volume,Growth,640,274985,0
3755,1381489,510081,91,0,Stable,Stable,581,276297,233784
3756,2317547,1091031,89,1,Stable,Growth,566,463509,627522
3757,1080975,328983,97,0,Stable,Declining,549,216195,112788
3758,802517,260935,97,0,High Volume,Growth,705,260935,0
3759,3263037,264370,84,0,Stable,Growth,622,264370,0
3760,3280885,1440356,93,1,Stable,Growth,588,656177,784179
3761,1041890,185927,92,0,Stable,Stable,564,185927,0
3762,4058339,1326156,81,1,High Volume,Growth,593,811667,514489
3763,1196293,586902,88,0,Low Volume,Growth,574,239258,347644
3764,2427888,772011,98,0,High Volume,Growth,712,772011,0
3765,3821965,1437515,94,1,Low Volume,Declining,447,764393,673122
3766,1930153,483298,96,1,Stable,Stable,557,386030,97268
3767,2852746,220131,90,0,High Volume,Growth,671,220131,0
3768,1311728,536391,95,0,Low Volume,Growth,588,262345,274046
3769,1694379,111405,90,0,High Volume,Declining,554,111405,0
3770,1681694,614316,96,1,Stable,Stable,533,336338,277978
3771,1091144,65812,94,1,Stable,Growth,604,65812,0
3772,1721283,753986,95,1,High Volume,Growth,630,516384,237602
3773,574414,69467,93,0,Stable,Growth,624,69467,0
3774,1338523,376690,93,0,Stable,Growth,611,376690,0
3775,1578680,503153,87,1,Unstable,Stable,456,315736,187417
3776,1615340,413358,91,0,Low Volume,Growth,585,323068,90290
3777,1634426,332350,85,0,Stable,Declining,515,326885,5465
3778,1887169,491639,83,2,Low Volume,Growth,480,377433,114206
3779,2909679,553238,96,0,Stable,Growth,640,553238,0
3780,3991245,986456,90,1,Low Volume,Growth,537,798249,188207
3781,1179013,249374,88,0,Low Volume,Growth,565,235802,13572
3782,757243,230802,96,0,Stable,Declining,524,151448,79354
3783,861443,135303,92,0,Stable,Declining,527,135303,0
3784,1342760,664526,97,0,Stable,Growth,624,402828,261698
3785,1496236,412051,88,0,Unstable,Stable,521,299247,112804
3786,1070893,147112,92,0,Stable,Stable,568,147112,0
3787,702996,186069,93,0,Low Volume,Growth,609,186069,0
3788,1376567,605534,85,0,Stable,Growth,585,275313,330221
3789,2292472,137120,95,0,High Volume,Growth,674,137120,0
3790,3191570,1135559,93,0,High Volume,Growth,678,957471,178088
3791,1269408,376488,94,1,Stable,Growth,576,253881,122607
3792,1424885,179965,97,1,Stable,Growth,608,179965,0
3793,944718,394764,97,1,Low Volume,Growth,585,188943,205821
3794,1933512,417635,85,0,High Volume,Declining,574,386702,30933
3795,1005763,183261,82,1,Stable,Growth,543,183261,0
3796,3136137,1325508,91,0,Stable,Stable,581,627227,698281
3797,500000,168668,94,0,Unstable,Stable,532,100000,68668
3798,1487037,675437,92,1,Low Volume,Stable,497,297407,378030
3799,2522815,841227,85,0,Stable,Growth,621,756844,84383
3800,2296892,880555,97,0,Stable,Declining,528,459378,421177
3801,17097228,7290269,92,0,Low Volume,Growth,598,3419445,3870824
3802,2623028,195764,93,0,High Volume,Declining,577,195764,0
3803,888026,354520,87,0,Stable,Growth,626,266407,88113
3804,1836971,599161,83,1,High Volume,Growth,612,551091,48070
3805,500000,40639,86,0,High Volume,Stable,606,40639,0
3806,1858946,518386,88,0,Stable,Stable,577,371789,146597
3807,1018208,88692,93,1,Unstable,Stable,493,88692,0
3808,4123910,1571937,93,0,Unstable,Stable,511,824782,747155
3809,1277439,378027,90,1,Unstable,Stable,464,255487,122540
3810,1805932,865237,94,0,High Volume,Growth,691,541779,323458
3811,1192490,157899,96,0,Low Volume,Declining,528,157899,0
3812,7969092,2571746,96,0,Low Volume,Stable,540,1593818,977928
3813,1533412,222670,94,0,Stable,Growth,650,222670,0
3814,8589453,2802990,95,0,Stable,Growth,641,2576835,226155
3815,3803078,1426886,95,0,Low Volume,Stable,560,760615,666271
3816,2915796,1093531,94,1,High Volume,Growth,649,874738,218793
3817,2663060,1109919,88,0,Stable,Declining,515,532612,577307
3818,2716997,1179442,96,0,Stable,Stable,601,815099,364343
3819,500000,42386,93,0,Stable,Growth,642,42386,0
3820,1586266,324344,95,0,Low Volume,Declining,494,317253,7091
3821,3898593,1400395,89,0,Stable,Declining,524,779718,620677
3822,1906696,523128,92,1,Stable,Declining,467,381339,141789
3823,644254,87492,91,1,Low Volume,Growth,572,87492,0
3824,1901353,567971,94,0,Low Volume,Stable,563,380270,187701
3825,7750628,1808578,95,0,Stable,Growth,622,1808578,0
3826,5376313,1212451,92,1,High Volume,Stable,591,1075262,137189
3827,1886807,781872,85,0,High Volume,Growth,654,566042,215830
3828,4244605,990773,91,0,Low Volume,Growth,612,990773,0
3829,1478878,91549,83,0,High Volume,Growth,669,91549,0
3830,507323,38622,96,1,Stable,Stable,546,38622,0
3831,946406,411980,98,0,High Volume,Declining,589,189281,222699
3832,6922663,3338595,95,0,Stable,Growth,652,2076798,1261797
3833,1592484,572951,93,0,High Volume,Stable,628,477745,95206
3834,1631961,349184,95,1,Stable,Growth,609,349184,0
3835,1559896,736848,92,0,Low Volume,Growth,607,467968,268880
3836,9095672,3167671,93,0,Low Volume,Growth,619,2728701,438970
3837,7280915,3130430,93,0,High Volume,Stable,617,2184274,946156
3838,11699120,4616865,93,0,Stable,Stable,572,2339824,2277041
3839,1745870,385161,87,0,Stable,Growth,621,385161,0
3840,2511773,666665,96,0,Stable,Stable,577,502354,164311
3841,589297,78824,99,0,Low Volume,Stable,555,78824,0
3842,6462634,1172363,89,0,High Volume,Growth,673,1172363,0
3843,779008,311725,99,0,High Volume,Stable,653,233702,78023
3844,2358227,1066603,90,0,High Volume,Declining,554,471645,594958
3845,824191,309902,94,0,High Volume,Growth,692,247257,62645
3846,1237875,321016,94,0,High Volume,Declining,579,247575,73441
3847,1014788,90244,86,0,Unstable,Growth,561,90244,0
3848,1219193,92203,92,0,High Volume,Growth,667,92203,0
3849,1288130,281387,97,0,High Volume,Declining,594,257626,23761
3850,1278739,330835,90,0,Stable,Declining,539,255747,75088
3851,3861889,1251655,97,0,Unstable,Growth,568,772377,479278
3852,819221,43353,99,0,Unstable,Growth,595,43353,0
3853,2365342,1171732,91,1,Stable,Growth,580,473068,698664
3854,5253302,1123011,93,0,High Volume,Growth,684,1123011,0
3855,1315126,567664,94,0,High Volume,Growth,688,394537,173127
3856,1116450,324591,91,0,Stable,Growth,615,324591,0
3857,1648836,179225,88,0,High Volume,Stable,608,179225,0
3858,5095051,2083389,97,0,Low Volume,Stable,550,1019010,1064379
3859,2315847,855525,93,0,Unstable,Stable,510,463169,392356
3860,1296305,372488,86,0,High Volume,Growth,675,372488,0
3861,2920021,822129,96,0,Stable,Stable,576,584004,238125
3862,820908,73361,92,0,Unstable,Declining,462,73361,0
3863,3419783,1180277,91,0,Low Volume,Declining,506,683956,496321
3864,2749380,1264881,99,0,Low Volume,Stable,557,549876,715005
3865,1549981,142537,82,0,Unstable,Growth,537,142537,0
3866,1013714,170892,99,0,Stable,Growth,652,170892,0
3867,975451,444843,79,0,Stable,Growth,575,195090,249753
3868,3041477,541245,98,0,Low Volume,Stable,549,541245,0
3869,5299825,1824595,85,0,Stable,Declining,514,1059965,764630
3870,1190821,346134,92,0,Stable,Declining,507,238164,107970
3871,2861079,910817,91,0,Low Volume,Growth,591,572215,338602
3872,500000,118553,85,0,Low Volume,Growth,569,100000,18553
3873,1242090,229782,92,0,Stable,Growth,613,229782,0
3874,1934100,138946,88,1,Stable,Growth,556,138946,0
3875,957665,368631,97,0,High Volume,Growth,699,287299,81332
3876,937334,361569,84,0,Low Volume,Growth,561,187466,174103
3877,1162143,408873,96,0,High Volume,Growth,690,348642,60231
3878,2504887,850748,96,0,Stable,Declining,556,500977,349771
3879,1706810,272531,92,0,Stable,Stable,581,272531,0
3880,500000,30028,92,0,Stable,Growth,646,30028,0
3881,500000,206961,96,0,Stable,Declining,524,100000,106961
3882,1220179,330684,98,0,High Volume,Growth,679,330684,0
3883,2859477,537802,96,2,Low Volume,Growth,536,537802,0
3884,500000,47935,87,0,High Volume,Growth,663,47935,0
3885,1329370,103990,89,0,High Volume,Declining,558,103990,0
3886,1301466,269390,87,0,High Volume,Declining,560,260293,9097
3887,6020436,2481212,91,0,Stable,Stable,593,1204087,1277125
3888,1457135,675274,95,0,Stable,Growth,619,437140,238134
3889,2693605,1221653,96,0,Low Volume,Declining,504,538721,682932
3890,2219973,1030068,88,1,High Volume,Growth,628,665991,364077
3891,500000,229238,88,1,Low Volume,Growth,527,100000,129238
3892,3665832,1053014,93,1,High Volume,Stable,586,733166,319848
3893,2355626,350369,85,1,Stable,Stable,523,350369,0
3894,2977561,1218183,88,0,Low Volume,Stable,549,595512,622671
3895,45854787,6702633,89,0,Stable,Declining,533,6702633,0
3896,500000,85122,97,2,Unstable,Growth,485,85122,0
3897,7879361,1221021,92,0,Stable,Stable,569,1221021,0
3898,1575435,443866,93,0,Low Volume,Declining,479,315087,128779
3899,2495159,486113,98,0,Stable,Growth,639,486113,0
3900,1911866,228220,88,1,Stable,Declining,459,228220,0
3901,1412132,358580,91,0,High Volume,Stable,626,358580,0
3902,1256868,557117,93,0,High Volume,Growth,674,377060,180057
3903,2580792,791655,86,2,Stable,Stable,481,516158,275497
3904,589047,262274,84,0,Stable,Declining,494,117809,144465
3905,3614497,499316,88,1,Unstable,Declining,409,499316,0
3906,1421246,177852,86,0,Low Volume,Growth,591,177852,0
3907,802867,248094,93,0,Low Volume,Declining,507,160573,87521
3908,1383310,357583,96,0,High Volume,Growth,708,357583,0
3909,5420612,1881373,91,0,Stable,Growth,615,1626183,255190
3910,1292039,526612,95,0,High Volume,Stable,623,387611,139001
3911,2641250,1025038,88,1,Stable,Growth,589,528250,496788
3912,1104866,523726,85,0,High Volume,Growth,660,331459,192267
3913,3635792,833379,89,0,Stable,Growth,621,833379,0
3914,3431151,490222,90,0,Stable,Stable,552,490222,0
3915,8700465,2591962,87,0,High Volume,Growth,644,2591962,0
3916,1722951,172010,99,0,Low Volume,Growth,619,172010,0
3917,3385201,609279,83,0,Stable,Growth,586,609279,0
3918,2144579,307854,90,0,High Volume,Growth,687,307854,0
3919,5591160,1277321,96,0,Unstable,Stable,519,1118232,159089
3920,1115635,111616,90,0,Stable,Stable,561,111616,0
3921,3598416,231482,94,0,High Volume,Declining,582,231482,0
3922,1696779,586334,84,0,Stable,Growth,618,509033,77301
3923,1883513,611411,87,0,Unstable,Growth,549,376702,234709
3924,2133772,786853,94,0,Unstable,Growth,563,426754,360099
3925,2426092,842276,92,0,High Volume,Stable,617,727827,114449
3926,1806708,183259,91,0,Low Volume,Growth,605,183259,0
3927,2354339,426101,87,0,Stable,Growth,620,426101,0
3928,7007520,758823,88,0,High Volume,Stable,604,758823,0
3929,4361645,1872618,94,0,Low Volume,Stable,550,872329,1000289
3930,3974159,1534449,98,0,Stable,Growth,651,1192247,342202
3931,1377207,193755,95,0,Stable,Growth,640,193755,0
3932,973455,198185,99,0,Stable,Stable,599,194691,3494
3933,4257703,2064887,97,0,Stable,Growth,661,1277310,787577
3934,3996132,1268259,94,0,Low Volume,Growth,619,1198839,69420
3935,6440628,2644007,90,0,Stable,Stable,586,1288125,1355882
3936,1222998,206767,94,0,High Volume,Growth,664,206767,0
3937,1650124,238482,83,0,Low Volume,Declining,459,238482,0
3938,534140,215132,84,0,High Volume,Growth,671,160242,54890
3939,1448477,519486,96,1,Unstable,Stable,495,289695,229791
3940,4400622,1568558,86,0,Stable,Growth,609,1320186,248372
3941,1365189,407762,93,0,High Volume,Stable,623,407762,0
3942,3309752,1004875,97,0,Stable,Growth,654,992925,11950
3943,1702482,648754,87,1,Stable,Stable,532,340496,308258
3944,2569561,440683,96,1,High Volume,Growth,630,440683,0
3945,791628,165249,91,0,High Volume,Growth,662,165249,0
3946,2122632,938705,96,0,Unstable,Stable,509,424526,514179
3947,500000,94495,93,0,Stable,Stable,580,94495,0
3948,1707401,505116,97,1,High Volume,Growth,634,505116,0
3949,538004,197010,94,1,Stable,Growth,595,107600,89410
3950,5203258,2601453,80,0,High Volume,Growth,649,1560977,1040476
3951,3692912,908017,93,0,High Volume,Declining,559,738582,169435
3952,2880103,698833,90,0,High Volume,Declining,568,576020,122813
3953,6694554,2873067,82,0,Low Volume,Growth,573,1338910,1534157
3954,928074,382809,99,0,High Volume,Growth,692,278422,104387
3955,8023542,3040795,88,0,Stable,Stable,564,1604708,1436087
3956,4179713,1080261,95,0,High Volume,Growth,705,1080261,0
3957,1640901,321243,92,0,Stable,Stable,587,321243,0
3958,4918411,1593215,77,0,Stable,Stable,511,983682,609533
3959,818284,363564,94,0,Stable,Stable,563,163656,199908
3960,1025190,458977,97,0,Stable,Growth,651,307557,151420
3961,1218496,120417,95,0,Stable,Growth,632,120417,0
3962,1298627,315252,90,0,Low Volume,Declining,486,259725,55527
3963,851499,220645,93,0,Stable,Declining,516,170299,50346
3964,5274880,2584306,96,0,Stable,Growth,627,1582464,1001842
3965,1611888,572380,91,0,Low Volume,Stable,555,322377,250003
3966,2628710,613175,92,0,High Volume,Growth,671,613175,0
3967,1256347,77549,95,0,Unstable,Stable,528,77549,0
3968,500000,152212,83,0,Low Volume,Growth,553,100000,52212
3969,2460920,229442,88,1,Stable,Stable,528,229442,0
3970,500000,212751,82,0,Stable,Stable,537,100000,112751
3971,1876826,729397,93,1,High Volume,Growth,622,563047,166350
3972,663542,170682,97,0,High Volume,Stable,656,170682,0
3973,9721211,2363662,97,0,Stable,Declining,521,1944242,419420
3974,4110644,1865421,87,1,High Volume,Growth,635,1233193,632228
3975,2157807,387987,90,0,High Volume,Stable,635,387987,0
3976,5449124,883079,98,0,Unstable,Growth,582,883079,0
3977,1007464,476167,92,0,High Volume,Growth,679,302239,173928
3978,3062627,1268420,90,0,Low Volume,Stable,525,612525,655895
3979,2326437,975432,87,1,Stable,Declining,461,465287,510145
3980,2449063,337572,96,0,Stable,Growth,619,337572,0
3981,5486948,628163,94,0,Low Volume,Declining,495,628163,0
3982,3562573,219858,87,0,High Volume,Growth,680,219858,0
3983,2497945,391350,97,0,Low Volume,Declining,504,391350,0
3984,527598,210188,90,0,Low Volume,Growth,603,158279,51909
3985,919847,145352,92,0,High Volume,Growth,656,145352,0
3986,1797366,679578,95,1,Stable,Declining,497,359473,320105
3987,2136539,349022,97,0,High Volume,Growth,671,349022,0
3988,802781,182939,93,0,Low Volume,Growth,606,182939,0
3989,13651246,6722188,84,1,Low Volume,Declining,445,2730249,3991939
3990,6669899,1068286,81,1,Stable,Declining,464,1068286,0
3991,3209721,704106,97,1,Stable,Stable,553,641944,62162
3992,2100381,389598,93,0,Stable,Declining,543,389598,0
3993,1673174,166198,97,0,Stable,Growth,648,166198,0
3994,925848,250398,93,1,Stable,Stable,523,185169,65229
3995,2109548,464967,96,0,High Volume,Stable,633,464967,0
3996,2436814,883830,81,0,High Volume,Declining,542,487362,396468
3997,734240,306852,95,1,Low Volume,Declining,464,146848,160004
3998,2590447,763955,94,0,Stable,Growth,628,763955,0
3999,1751167,112930,93,0,Stable,Growth,613,112930,0
4000,500000,164258,97,0,Stable,Stable,590,100000,64258
4001,996189,74640,91,0,Stable,Declining,507,74640,0
4002,1424193,466224,84,1,High Volume,Growth,594,284838,181386
4003,8976765,3216047,88,0,Stable,Growth,625,2693029,523018
4004,3094827,430167,87,0,Stable,Growth,615,430167,0
4005,681202,285223,94,1,Low Volume,Growth,575,136240,148983
4006,2925070,1345498,95,0,Stable,Growth,615,877521,467977
4007,575018,239144,97,0,High Volume,Growth,672,172505,66639
4008,4714497,883021,88,1,Low Volume,Growth,533,883021,0
4009,1360143,427070,95,1,Stable,Stable,542,272028,155042
4010,1839659,849310,87,0,Unstable,Stable,493,367931,481379
4011,5726627,1112679,89,0,Unstable,Stable,508,1112679,0
4012,708049,296681,94,0,Low Volume,Growth,588,141609,155072
4013,648427,35186,97,0,High Volume,Growth,701,35186,0
4014,1243102,64195,93,1,High Volume,Growth,650,64195,0
4015,4550297,1783126,93,0,Low Volume,Stable,530,910059,873067
4016,588024,230888,92,1,Stable,Growth,602,176407,54481
4017,500000,202520,94,0,High Volume,Growth,665,150000,52520
4018,1382042,647503,94,0,High Volume,Growth,692,414612,232891
4019,3082935,317721,92,0,Stable,Growth,613,317721,0
4020,5179450,799672,89,0,Low Volume,Declining,479,799672,0
4021,1368835,625114,99,0,Stable,Declining,528,273767,351347
4022,1426677,185120,89,0,Stable,Growth,600,185120,0
4023,4990869,1781756,93,0,Low Volume,Stable,558,998173,783583
4024,500000,144354,98,1,Low Volume,Growth,583,100000,44354
4025,1453062,127052,85,0,Unstable,Declining,441,127052,0
4026,2309032,411859,88,0,High Volume,Declining,559,411859,0
4027,2840171,807084,93,1,Unstable,Growth,540,568034,239050
4028,1318697,571731,94,1,Stable,Stable,524,263739,307992
4029,2038149,750838,92,2,High Volume,Growth,603,611444,139394
4030,500000,164924,89,1,Stable,Stable,507,100000,64924
4031,1171038,319945,90,1,High Volume,Growth,634,319945,0
4032,2849936,525550,86,0,High Volume,Growth,668,525550,0
4033,903621,93670,94,1,Unstable,Declining,438,93670,0
4034,2078563,486559,95,0,High Volume,Growth,677,486559,0
4035,2834846,178123,95,0,Unstable,Growth,581,178123,0
4036,1507496,218549,91,1,Stable,Declining,485,218549,0
4037,2272454,555882,85,0,Unstable,Growth,528,454490,101392
4038,917873,218796,88,0,Low Volume,Declining,471,183574,35222
4039,1680683,117535,93,0,Stable,Growth,627,117535,0
4040,3230582,1017882,96,0,Stable,Declining,535,646116,371766
4041,2248060,668478,91,1,Unstable,Growth,537,449612,218866
4042,1240190,105598,92,1,Stable,Stable,550,105598,0
4043,2372306,1125477,96,0,High Volume,Declining,602,711691,413786
4044,3511970,332662,98,0,Unstable,Declining,474,332662,0
4045,500000,217338,88,0,Stable,Growth,630,150000,67338
4046,5011567,251277,87,0,High Volume,Declining,552,251277,0
4047,1515106,677293,90,0,Low Volume,Growth,585,303021,374272
4048,2786765,164068,89,1,Stable,Growth,568,164068,0
4049,5166973,2020366,93,0,Stable,Stable,566,1033394,986972
4050,661762,140797,83,0,Stable,Stable,529,132352,8445
4051,1124048,429608,84,0,High Volume,Growth,637,337214,92394
4052,1574048,363267,94,0,Stable,Growth,618,363267,0
4053,1059171,86755,92,1,Stable,Declining,466,86755,0
4054,7944173,3140951,96,1,Stable,Declining,516,1588834,1552117
4055,999072,81988,84,1,Unstable,Stable,445,81988,0
4056,1271315,591103,91,2,Low Volume,Declining,426,254263,336840
4057,2334974,170309,91,0,Stable,Declining,530,170309,0
4058,757880,201366,98,1,Stable,Growth,584,151576,49790
4059,1444762,542314,90,0,Low Volume,Growth,595,288952,253362
4060,2556022,580117,87,1,Stable,Declining,486,511204,68913
4061,1519226,224473,97,0,Stable,Stable,604,224473,0
4062,1840026,720537,85,0,Stable,Declining,509,368005,352532
4063,1298259,523111,98,0,Stable,Stable,597,259651,263460
4064,590322,274625,82,2,Unstable,Stable,421,118064,156561
4065,2564501,562329,93,0,High Volume,Declining,565,512900,49429
4066,8072279,2242586,95,0,Stable,Stable,604,2242586,0
4067,2012164,429411,92,0,Unstable,Growth,570,402432,26979
4068,2374295,393389,98,0,Unstable,Stable,544,393389,0
4069,3451012,1338871,89,0,Low Volume,Stable,553,690202,648669
4070,718223,145687,96,0,Stable,Growth,630,145687,0
4071,7740770,1878431,90,0,Stable,Growth,619,1878431,0
4072,2331128,540013,81,0,High Volume,Stable,601,540013,0
4073,7315351,2711783,84,0,Stable,Growth,612,2194605,517178
4074,1103032,510713,99,0,Stable,Growth,650,330909,179804
4075,8490424,2971990,99,0,High Volume,Stable,629,2547127,424863
4076,3686265,966584,94,0,Low Volume,Stable,565,737253,229331
4077,3086141,1236439,95,1,Stable,Stable,530,617228,619211
4078,2390994,809201,86,0,Low Volume,Stable,542,478198,331003
4079,1625258,125591,95,0,Stable,Declining,527,125591,0
4080,5180568,482045,96,0,Stable,Stable,607,482045,0
4081,2218380,148770,92,0,High Volume,Growth,666,148770,0
4082,500000,127784,93,0,Stable,Growth,621,127784,0
4083,811185,342023,92,0,Stable,Growth,633,243355,98668
4084,1708837,326195,92,0,Unstable,Stable,499,326195,0
4085,2540824,566279,97,0,Stable,Declining,542,508164,58115
4086,1895000,870307,95,0,Stable,Declining,551,379000,491307
4087,5257555,2242907,95,0,Low Volume,Growth,602,1577266,665641
4088,500000,174636,100,0,Stable,Stable,581,100000,74636
4089,2224117,378237,95,0,Low Volume,Stable,567,378237,0
4090,500000,51334,86,0,Stable,Stable,542,51334,0
4091,3641003,208362,85,0,Stable,Declining,496,208362,0
4092,1838449,180453,92,1,Stable,Growth,581,180453,0
4093,2773687,503891,90,0,Stable,Stable,579,503891,0
4094,993405,296338,89,1,High Volume,Growth,624,296338,0
4095,5518253,434839,97,1,Stable,Growth,607,434839,0
4096,4562493,507817,95,0,Stable,Declining,541,507817,0
4097,3162380,415810,90,0,Stable,Stable,560,415810,0
4098,1787603,597760,88,0,Stable,Stable,556,357520,240240
4099,3153066,1031385,92,0,Stable,Declining,507,630613,400772
4100,1126342,335475,91,0,Low Volume,Declining,497,225268,110207
4101,3931158,639700,80,1,Stable,Growth,562,639700,0
4102,7419222,1610000,90,0,High Volume,Stable,634,1610000,0
4103,4669154,436614,91,0,Low Volume,Stable,546,436614,0
4104,1106064,168019,96,0,Stable,Stable,568,168019,0
4105,2647520,1201888,97,0,Low Volume,Growth,615,794256,407632
4106,704671,345896,87,1,Stable,Stable,513,140934,204962
4107,3134287,1070192,99,0,Unstable,Growth,600,940286,129906
4108,2843319,1315235,84,0,High Volume,Growth,646,852995,462240
4109,500000,169617,89,0,High Volume,Stable,602,150000,19617
4110,782753,50831,92,0,Stable,Growth,623,50831,0
4111,1580875,788134,92,0,Unstable,Growth,573,316175,471959
4112,1558621,147334,91,0,High Volume,Growth,674,147334,0
4113,753450,269124,98,0,Low Volume,Declining,501,150690,118434
4114,2706544,443268,85,0,High Volume,Declining,558,443268,0
4115,2424604,548910,83,0,High Volume,Declining,540,484920,63990
4116,1697360,578240,85,1,Stable,Growth,568,339472,238768
4117,1083131,266904,95,0,Stable,Growth,615,266904,0
4118,4588050,746686,88,1,High Volume,Stable,593,746686,0
4119,7454480,1494629,82,1,High Volume,Declining,513,1490896,3733
4120,1346677,274314,93,0,High Volume,Growth,666,274314,0
4121,1215014,585267,92,0,Stable,Growth,608,364504,220763
4122,2937197,1202418,88,1,High Volume,Growth,620,881159,321259
4123,1488942,381686,86,1,Stable,Growth,556,297788,83898
4124,1773530,248151,91,0,High Volume,Growth,663,248151,0
4125,3583041,1486809,92,0,Stable,Growth,646,1074912,411897
4126,500000,60366,83,0,Low Volume,Growth,582,60366,0
4127,5692396,823735,96,1,High Volume,Declining,547,823735,0
4128,2101463,451197,92,0,Stable,Growth,624,451197,0
4129,1426601,636488,89,0,High Volume,Declining,580,285320,351168
4130,1846149,201791,97,0,Low Volume,Growth,599,201791,0
4131,1924051,202036,97,0,Low Volume,Stable,559,202036,0
4132,500000,136144,94,0,Stable,Declining,549,100000,36144
4133,6556389,1143334,83,0,High Volume,Growth,653,1143334,0
4134,2049406,626970,97,0,High Volume,Growth,698,614821,12149
4135,2826082,715667,98,1,Stable,Declining,516,565216,150451
4136,4244947,1043118,96,0,Stable,Growth,655,1043118,0
4137,875955,87935,92,0,Stable,Declining,519,87935,0
4138,2895816,328595,91,1,Stable,Growth,588,328595,0
4139,1600597,671427,92,0,High Volume,Growth,680,480179,191248
4140,3903627,1751351,84,0,Stable,Declining,512,780725,970626
4141,500000,77804,93,0,High Volume,Declining,589,77804,0
4142,1831644,185101,95,0,Unstable,Growth,581,185101,0
4143,1224133,90632,90,0,High Volume,Stable,625,90632,0
4144,2801906,907072,93,0,High Volume,Growth,672,840571,66501
4145,2887886,1074031,92,0,Stable,Growth,607,866365,207666
4146,1125682,245134,94,1,High Volume,Growth,627,245134,0
4147,1121593,399124,88,0,Low Volume,Growth,589,224318,174806
4148,1814767,672973,77,1,Low Volume,Growth,524,362953,310020
4149,967709,455698,94,1,Stable,Growth,591,193541,262157
4150,3888706,307959,92,1,Low Volume,Stable,526,307959,0
4151,1475687,201477,93,0,Low Volume,Stable,568,201477,0
4152,500000,40418,81,0,High Volume,Stable,608,40418,0
4153,1469073,647270,96,0,Low Volume,Growth,590,293814,353456
4154,863859,351301,96,0,Low Volume,Growth,622,259157,92144
4155,537659,165916,92,0,Stable,Stable,591,107531,58385
4156,736790,64579,90,0,Low Volume,Growth,596,64579,0
4157,2164125,374373,93,1,Low Volume,Growth,546,374373,0
4158,5739672,1055950,93,0,Low Volume,Stable,557,1055950,0
4159,2547308,770139,76,0,High Volume,Growth,639,764192,5947
4160,1220532,202754,94,0,High Volume,Growth,681,202754,0
4161,2855402,236518,85,0,Unstable,Stable,484,236518,0
4162,1373301,520266,91,0,Stable,Declining,520,274660,245606
4163,1137473,209962,93,1,Stable,Declining,501,209962,0
4164,787414,199663,96,0,Unstable,Growth,560,157482,42181
4165,500000,53725,87,1,High Volume,Growth,626,53725,0
4166,1451432,596752,88,1,Stable,Stable,522,290286,306466
4167,2250005,685103,92,0,Stable,Growth,644,675001,10102
4168,1835268,836356,94,0,High Volume,Declining,600,550580,285776
4169,1421505,388017,97,0,Stable,Growth,622,388017,0
4170,930431,440691,85,0,Low Volume,Declining,476,186086,254605
4171,3225495,1455797,97,0,High Volume,Declining,596,645099,810698
4172,691276,213886,83,1,Low Volume,Stable,481,138255,75631
4173,3688839,1734684,92,0,Unstable,Growth,578,737767,996917
4174,889332,173767,90,0,Unstable,Stable,517,173767,0
4175,1086043,232999,91,1,Stable,Growth,593,217208,15791
4176,613277,43215,90,0,Low Volume,Declining,472,43215,0
4177,1327593,418378,90,0,Low Volume,Growth,572,265518,152860
4178,4326416,1621825,81,1,Low Volume,Growth,504,865283,756542
4179,2995143,1192317,91,0,Stable,Stable,581,599028,593289
4180,4337192,509261,97,0,Stable,Growth,651,509261,0
4181,3010793,752312,98,0,High Volume,Stable,638,752312,0
4182,820004,106263,88,0,High Volume,Growth,653,106263,0
4183,1521746,529503,88,1,Stable,Stable,525,304349,225154
4184,1062187,128605,92,0,Stable,Growth,639,128605,0
4185,5748560,2626366,84,0,Stable,Growth,618,1724568,901798
4186,761137,117052,95,0,Unstable,Stable,544,117052,0
4187,4052960,734117,89,0,High Volume,Stable,605,734117,0
4188,4050549,1753514,95,0,Low Volume,Growth,598,810109,943405
4189,8569296,2196400,79,1,High Volume,Growth,596,1713859,482541
4190,1428665,86860,97,0,Stable,Stable,605,86860,0
4191,3505549,955486,90,0,Stable,Growth,600,955486,0
4192,12302604,1083177,97,2,High Volume,Stable,566,1083177,0
4193,1209704,596874,88,0,Low Volume,Growth,579,241940,354934
4194,580687,182713,82,0,Stable,Declining,491,116137,66576
4195,500000,82720,87,0,Stable,Growth,604,82720,0
4196,3506643,1064873,90,0,Unstable,Stable,514,701328,363545
4197,500000,42295,97,0,High Volume,Stable,641,42295,0
4198,1472018,603455,88,0,Stable,Stable,558,294403,309052
4199,2813249,1312093,91,0,Stable,Declining,504,562649,749444
4200,2299358,1019765,92,0,Stable,Declining,510,459871,559894
4201,2786664,567897,95,1,Stable,Growth,593,557332,10565
4202,2368653,465667,86,0,Low Volume,Declining,498,465667,0
4203,5515609,362869,93,0,Stable,Growth,619,362869,0
4204,925553,317585,97,0,Stable,Growth,648,277665,39920
4205,1153607,335362,88,1,Low Volume,Stable,475,230721,104641
4206,1068613,274319,92,0,High Volume,Declining,588,213722,60597
4207,3852194,1765976,86,0,Stable,Stable,558,770438,995538
4208,4074746,511566,95,0,Stable,Declining,542,511566,0
4209,2844734,154611,89,0,Stable,Declining,536,154611,0
4210,5110434,424127,87,0,Stable,Stable,557,424127,0
4211,772639,116295,96,1,Low Volume,Growth,559,116295,0
4212,7525285,488982,98,1,Stable,Growth,624,488982,0
4213,6706521,1852875,98,1,Low Volume,Growth,584,1341304,511571
4214,3571505,683374,93,0,Stable,Stable,583,683374,0
4215,8247652,1082235,94,1,Unstable,Growth,531,1082235,0
4216,526866,204181,86,0,Stable,Growth,610,158059,46122
4217,1303341,185078,96,0,Low Volume,Growth,593,185078,0
4218,1101031,395735,98,0,Low Volume,Declining,509,220206,175529
4219,3531324,731582,91,0,Stable,Growth,605,731582,0
4220,855882,239923,90,1,Stable,Growth,586,171176,68747
4221,3634551,1709112,82,1,Stable,Stable,496,726910,982202
4222,5935305,396527,95,0,Stable,Declining,517,396527,0
4223,3457866,951325,87,1,High Volume,Stable,573,691573,259752
4224,2488028,1081024,98,0,Low Volume,Growth,632,746408,334616
4225,899596,283002,96,0,High Volume,Growth,675,269878,13124
4226,1007033,175820,84,1,High Volume,Stable,558,175820,0
4227,5388056,1233631,96,0,Low Volume,Growth,597,1077611,156020
4228,3698653,1317163,85,0,Stable,Stable,560,739730,577433
4229,1921822,866483,90,1,High Volume,Growth,640,576546,289937
4230,1419297,97193,92,0,Stable,Stable,595,97193,0
4231,500000,41096,80,0,Low Volume,Stable,510,41096,0
4232,841817,165226,97,1,Stable,Stable,556,165226,0
4233,9148818,1415787,86,0,Stable,Declining,519,1415787,0
4234,711859,120460,93,0,Stable,Stable,573,120460,0
4235,2307289,345105,99,0,High Volume,Growth,703,345105,0
4236,4439069,613130,92,0,Stable,Declining,527,613130,0
4237,726549,79035,95,1,High Volume,Stable,612,79035,0
4238,2298502,1080938,89,0,Stable,Growth,623,689550,391388
4239,4198897,482391,95,0,Stable,Stable,583,482391,0
4240,2002685,284345,96,0,Stable,Growth,625,284345,0
4241,19672307,3163692,99,0,Stable,Growth,653,3163692,0
4242,521842,245191,84,2,Stable,Stable,488,104368,140823
4243,4624981,1804073,93,0,Stable,Growth,642,1387494,416579
4244,1726762,699968,89,0,Stable,Declining,525,345352,354616
4245,3676737,357163,96,1,Stable,Stable,562,357163,0
4246,2822252,1203237,96,0,Stable,Stable,608,846675,356562
4247,1102924,257739,95,0,Low Volume,Growth,608,257739,0
4248,2381395,400718,95,1,Stable,Stable,526,400718,0
4249,500000,154544,92,0,Unstable,Stable,535,100000,54544
4250,3212622,1349244,99,0,Stable,Growth,642,963786,385458
4251,2516870,1007738,88,0,Stable,Growth,594,503374,504364
4252,3304938,1488871,94,0,Unstable,Growth,586,660987,827884
4253,4622724,2161861,93,0,Low Volume,Stable,533,924544,1237317
4254,2660690,418141,95,0,Stable,Stable,575,418141,0
4255,2232140,537357,99,1,Low Volume,Declining,481,446428,90929
4256,979841,55442,87,0,Stable,Stable,548,55442,0
4257,1121551,499869,90,0,Low Volume,Growth,584,224310,275559
4258,5123702,612577,90,0,High Volume,Growth,688,612577,0
4259,6256105,2738070,91,0,Unstable,Growth,545,1251221,1486849
4260,1638860,324862,98,0,Stable,Growth,651,324862,0
4261,2057089,443632,98,0,High Volume,Stable,651,443632,0
4262,961556,65010,96,0,Low Volume,Declining,500,65010,0
4263,5066726,998629,95,0,Low Volume,Stable,540,998629,0
4264,3376443,1518601,88,0,Low Volume,Growth,567,675288,843313
4265,9369534,576192,95,0,Stable,Growth,651,576192,0
4266,981995,228655,92,0,Unstable,Growth,579,196399,32256
4267,1465334,93972,89,1,Stable,Growth,561,93972,0
4268,2386066,517575,84,0,Low Volume,Growth,591,477213,40362
4269,3325703,424653,83,0,Stable,Stable,558,424653,0
4270,1668551,272805,90,0,Low Volume,Declining,510,272805,0
4271,986216,438787,91,0,Unstable,Growth,553,197243,241544
4272,4013307,988165,88,0,Stable,Growth,624,988165,0
4273,3530353,611489,94,1,Low Volume,Growth,552,611489,0
4274,952629,300271,81,0,High Volume,Growth,658,285788,14483
4275,5864069,668200,88,1,Stable,Stable,515,668200,0
4276,5056368,843029,93,0,Stable,Stable,582,843029,0
4277,2207646,653047,92,0,Low Volume,Declining,494,441529,211518
4278,2113125,331518,88,0,Stable,Growth,628,331518,0
4279,3088655,1098349,86,0,Stable,Declining,488,617731,480618
4280,995139,269853,90,0,Unstable,Declining,445,199027,70826
4281,2030972,807098,89,0,High Volume,Growth,648,609291,197807
4282,500000,238355,90,1,Stable,Growth,579,100000,138355
4283,3997439,408187,91,1,Low Volume,Stable,494,408187,0
4284,568528,114046,99,0,Stable,Stable,586,113705,341
4285,6601027,1279260,92,0,High Volume,Growth,694,1279260,0
4286,1522560,179711,87,1,Low Volume,Growth,528,179711,0
4287,1673899,694059,94,0,Stable,Stable,595,334779,359280
4288,1199977,470325,85,1,High Volume,Stable,547,239995,230330
4289,1574690,422003,97,1,High Volume,Growth,649,422003,0
4290,6167629,1800928,91,0,Low Volume,Stable,542,1233525,567403
4291,500000,38397,87,0,Stable,Stable,579,38397,0
4292,5507230,1652050,90,1,Low Volume,Growth,532,1101446,550604
4293,2598432,1055233,97,1,Stable,Growth,586,519686,535547
4294,754932,232687,94,0,Low Volume,Growth,615,226479,6208
4295,838819,142086,86,0,Low Volume,Growth,575,142086,0
4296,7580687,2656248,90,0,Stable,Growth,621,2274206,382042
4297,930609,197912,87,1,Unstable,Stable,471,186121,11791
4298,788052,232627,82,0,Stable,Growth,586,157610,75017
4299,4925083,1326839,97,0,High Volume,Growth,672,1326839,0
4300,2599533,575871,92,1,High Volume,Growth,639,575871,0
4301,936270,349692,95,0,Low Volume,Growth,591,187254,162438
4302,2357943,1055755,96,0,Stable,Growth,624,707382,348373
4303,872744,45684,99,0,High Volume,Growth,700,45684,0
4304,4783376,2248796,95,0,Stable,Growth,646,1435012,813784
4305,4634768,1298578,84,1,Low Volume,Growth,532,926953,371625
4306,3034645,1108645,97,0,High Volume,Stable,637,910393,198252
4307,2648036,1151978,86,1,Stable,Growth,579,529607,622371
4308,8112775,2110917,97,0,Low Volume,Stable,565,1622555,488362
4309,1982262,843925,92,0,Unstable,Growth,578,396452,447473
4310,770273,100081,93,0,High Volume,Growth,675,100081,0
4311,2840751,345507,93,0,Stable,Declining,541,345507,0
4312,10520514,3638647,97,0,Stable,Growth,644,3156154,482493
4313,880454,388777,94,1,Stable,Stable,559,176090,212687
4314,1484858,670550,79,0,High Volume,Growth,652,445457,225093
4315,2766675,939793,86,0,Low Volume,Growth,573,553335,386458
4316,1899072,544027,99,0,Stable,Stable,601,544027,0
4317,903614,179934,86,0,High Volume,Growth,643,179934,0
4318,4864557,2388498,89,1,Low Volume,Growth,553,972911,1415587
4319,12686292,2459403,99,1,Stable,Stable,574,2459403,0
4320,2319600,892776,95,0,High Volume,Growth,675,695880,196896
4321,961977,278388,89,0,Stable,Growth,625,278388,0
4322,574257,185962,93,0,High Volume,Growth,688,172277,13685
4323,2437250,553417,90,1,Low Volume,Growth,565,487450,65967
4324,4795084,2321638,89,0,High Volume,Stable,623,1438525,883113
4325,2899747,890968,89,1,Low Volume,Stable,483,579949,311019
4326,1978950,934073,94,0,High Volume,Growth,663,593685,340388
4327,1237474,66101,90,0,High Volume,Growth,658,66101,0
4328,827587,254650,96,0,Stable,Declining,541,165517,89133
4329,3866271,1441091,90,1,Unstable,Growth,527,773254,667837
4330,4118573,1586829,85,0,Unstable,Growth,543,823714,763115
4331,575743,263252,89,0,High Volume,Stable,611,172722,90530
4332,7073537,367688,96,0,Stable,Growth,619,367688,0
4333,3138505,157392,91,0,Stable,Growth,616,157392,0
4334,6074898,1594773,85,1,High Volume,Growth,612,1594773,0
4335,677590,42812,94,0,Stable,Stable,571,42812,0
4336,664866,324813,89,0,Low Volume,Growth,572,132973,191840
4337,1760000,263876,92,1,High Volume,Declining,546,263876,0
4338,2964525,778778,88,0,Stable,Growth,614,778778,0
4339,8344295,646782,82,0,High Volume,Stable,598,646782,0
4340,3488084,993831,89,0,Stable,Growth,613,993831,0
4341,1632879,360834,95,0,Stable,Stable,603,360834,0
4342,872314,61147,98,0,Low Volume,Growth,627,61147,0
4343,5304152,1065105,95,1,Low Volume,Growth,551,1060830,4275
4344,916425,207246,99,1,Low Volume,Growth,562,183285,23961
4345,7295548,3614686,93,2,Low Volume,Growth,499,1459109,2155577
4346,1579300,226706,91,1,Stable,Declining,480,226706,0
4347,7077743,2089002,89,0,High Volume,Declining,581,1415548,673454
4348,3413146,1687091,99,0,Unstable,Declining,469,682629,1004462
4349,1776940,722164,88,1,Stable,Declining,454,355388,366776
4350,1308619,650404,94,0,Stable,Stable,564,261723,388681
4351,1509477,733205,88,0,High Volume,Growth,661,452843,280362
4352,2793074,754948,98,1,Stable,Growth,598,558614,196334
4353,2109002,766346,97,0,Unstable,Declining,474,421800,344546
4354,1232988,122928,91,0,Stable,Growth,639,122928,0
4355,1736696,431598,92,0,Low Volume,Growth,592,347339,84259
4356,2111400,874243,93,0,High Volume,Growth,686,633420,240823
4357,500000,138700,91,1,Stable,Growth,578,100000,38700
4358,2860579,1047586,84,0,High Volume,Stable,610,858173,189413
4359,905482,349143,92,0,Stable,Stable,574,181096,168047
4360,788064,129291,94,0,Stable,Declining,535,129291,0
4361,514075,228283,100,0,High Volume,Growth,699,154222,74061
4362,500000,128460,89,0,Stable,Growth,624,128460,0
4363,670408,96930,91,1,High Volume,Stable,583,96930,0
4364,1124426,494115,91,2,Stable,Growth,545,224885,269230
4365,9460231,2251710,90,1,Unstable,Growth,505,1892046,359664
4366,1301849,504650,98,0,High Volume,Stable,631,390554,114096
4367,2285739,677984,90,0,Stable,Growth,610,677984,0
4368,2731565,605977,98,0,High Volume,Growth,710,605977,0
4369,2201946,912584,83,1,High Volume,Growth,598,440389,472195
4370,1863646,583343,90,0,Stable,Growth,616,559093,24250
4371,762048,172035,94,0,Stable,Stable,573,152409,19626
4372,6329565,628646,89,0,Low Volume,Growth,583,628646,0
4373,8416943,3812458,91,2,Stable,Stable,510,1683388,2129070
4374,516006,34036,94,0,High Volume,Declining,587,34036,0
4375,873949,383169,86,2,High Volume,Declining,481,174789,208380
4376,1585090,336012,98,0,High Volume,Growth,675,336012,0
4377,916548,309520,88,0,Unstable,Stable,517,183309,126211
4378,2972080,1381987,96,0,High Volume,Stable,649,891624,490363
4379,1107241,130951,92,0,High Volume,Growth,679,130951,0
4380,11206952,3419552,92,0,High Volume,Growth,685,3362085,57467
4381,5139359,2024881,83,1,Stable,Declining,452,1027871,997010
4382,2350313,918767,95,0,Stable,Stable,586,470062,448705
4383,4509014,1291987,87,1,High Volume,Stable,579,901802,390185
4384,4802851,1590381,95,1,Low Volume,Growth,564,960570,629811
4385,1262800,493612,96,0,Low Volume,Growth,603,378840,114772
4386,1032018,442181,86,0,Stable,Growth,603,309605,132576
4387,2110667,829104,87,0,Stable,Stable,548,422133,406971
4388,3950327,826812,98,0,High Volume,Growth,675,826812,0
4389,2216075,1104773,88,0,Stable,Growth,617,664822,439951
4390,561520,137868,89,0,Low Volume,Growth,582,112304,25564
4391,1043134,63641,83,0,High Volume,Declining,544,63641,0
4392,1868827,398392,96,2,Low Volume,Stable,459,373765,24627
4393,1866298,200631,96,0,Low Volume,Growth,591,200631,0
4394,9607300,1005396,89,1,Unstable,Growth,506,1005396,0
4395,654227,115596,76,1,Stable,Growth,540,115596,0
4396,2971185,219924,91,0,High Volume,Growth,666,219924,0
4397,6525907,2348220,88,0,Stable,Growth,617,1957772,390448
4398,12202602,1016416,91,0,Stable,Declining,512,1016416,0
4399,1434723,202985,88,1,High Volume,Declining,534,202985,0
4400,2937718,269697,92,0,Stable,Declining,531,269697,0
4401,3127699,245291,89,1,Low Volume,Growth,541,245291,0
4402,2318394,395259,94,0,Stable,Growth,638,395259,0
4403,1832009,563076,82,1,High Volume,Stable,563,366401,196675
4404,2810240,1360461,93,1,Stable,Stable,539,562048,798413
4405,500000,222000,87,0,Stable,Growth,604,150000,72000
4406,3421726,1519829,82,0,Low Volume,Growth,552,684345,835484
4407,2193354,283448,87,0,High Volume,Growth,679,283448,0
4408,1659489,280799,94,0,Stable,Stable,567,280799,0
4409,10195834,860294,83,0,Low Volume,Growth,583,860294,0
4410,1155510,462563,93,0,High Volume,Growth,674,346653,115910
4411,1436240,116935,88,1,Stable,Stable,529,116935,0
4412,9754533,2931364,94,0,High Volume,Growth,665,2926359,5005
4413,1019019,164616,84,0,Stable,Stable,541,164616,0
4414,1276851,203722,90,0,Low Volume,Growth,610,203722,0
4415,1762739,874012,95,1,Stable,Growth,600,528821,345191
4416,3884821,1517220,86,0,Stable,Growth,600,1165446,351774
4417,2341359,998877,96,0,High Volume,Declining,575,468271,530606
4418,704962,216700,86,1,Stable,Growth,574,140992,75708
4419,1295316,572473,76,1,High Volume,Stable,529,259063,313410
4420,1219701,415273,97,0,Stable,Declining,552,243940,171333
4421,1863977,886840,89,1,Stable,Growth,572,372795,514045
4422,2787554,492289,96,0,High Volume,Growth,702,492289,0
4423,2770573,880748,95,0,Unstable,Declining,476,554114,326634
4424,500000,180280,95,0,High Volume,Growth,671,150000,30280
4425,4644307,1053430,98,0,Low Volume,Declining,525,928861,124569
4426,2426730,1082003,95,1,High Volume,Stable,601,728019,353984
4427,6002134,2946516,94,2,Low Volume,Growth,519,1200426,1746090
4428,2828787,769985,85,0,Stable,Growth,625,769985,0
4429,4785296,1080464,91,0,Low Volume,Stable,533,957059,123405
4430,2879814,755583,94,1,Low Volume,Stable,530,575962,179621
4431,5820988,2524746,87,0,Stable,Growth,597,1164197,1360549
4432,3011053,1025145,92,0,Stable,Stable,584,602210,422935
4433,1833373,128607,96,0,Stable,Growth,621,128607,0
4434,12212222,3590106,86,0,Low Volume,Growth,574,2442444,1147662
4435,4037877,233329,89,0,Stable,Growth,621,233329,0
4436,3137684,1256143,92,0,Stable,Growth,643,941305,314838
4437,714227,141232,89,0,High Volume,Stable,633,141232,0
4438,707402,185625,78,0,Low Volume,Growth,543,141480,44145
4439,2505935,1025943,96,1,High Volume,Growth,663,751780,274163
4440,2227559,157938,94,0,High Volume,Stable,627,157938,0
4441,1213115,147204,96,0,High Volume,Stable,629,147204,0
4442,2219486,508445,97,0,Low Volume,Growth,607,508445,0
4443,7066681,1084498,96,1,Stable,Stable,536,1084498,0
4444,3458419,698793,98,0,High Volume,Stable,663,698793,0
4445,795872,397282,91,0,Stable,Growth,634,238761,158521
4446,1813543,764293,99,0,High Volume,Growth,694,544062,220231
4447,1041348,466270,95,0,Stable,Declining,538,208269,258001
4448,1454016,685822,91,0,Low Volume,Stable,530,290803,395019
4449,1424181,289709,93,0,High Volume,Growth,691,289709,0
4450,1353066,248537,86,0,High Volume,Stable,599,248537,0
4451,726426,112834,96,1,High Volume,Stable,611,112834,0
4452,1790269,758273,97,0,Stable,Growth,623,537080,221193
4453,1266179,450504,92,0,High Volume,Declining,595,253235,197269
4454,500000,78139,86,0,Low Volume,Stable,508,78139,0
4455,10245792,2250460,95,0,Low Volume,Growth,613,2250460,0
4456,4737479,1317115,86,0,High Volume,Declining,542,947495,369620
4457,1467337,422099,91,0,High Volume,Growth,690,422099,0
4458,2012836,905630,95,1,Stable,Stable,545,402567,503063
4459,776597,171826,97,1,Low Volume,Stable,534,155319,16507
4460,7698825,3532497,87,0,Unstable,Stable,510,1539765,1992732
4461,9045979,2248970,94,2,Stable,Growth,551,1809195,439775
4462,2247558,867260,90,0,Unstable,Growth,570,449511,417749
4463,4496566,2107156,99,1,High Volume,Growth,660,1348969,758187
4464,2281239,1045741,98,1,High Volume,Growth,673,684371,361370
4465,680525,51467,86,1,Low Volume,Declining,454,51467,0
4466,1426225,203333,90,1,Stable,Growth,561,203333,0
4467,2203467,583054,91,0,High Volume,Growth,662,583054,0
4468,1378301,336580,96,0,High Volume,Growth,697,336580,0
4469,1664570,563293,97,0,High Volume,Stable,659,499371,63922
4470,1842954,875623,97,0,Stable,Growth,622,552886,322737
4471,1858531,186935,95,1,Low Volume,Growth,581,186935,0
4472,2067409,523750,95,0,Stable,Growth,617,523750,0
4473,848747,115926,92,0,Unstable,Stable,507,115926,0
4474,1117257,505389,97,1,Stable,Growth,615,335177,170212
4475,709512,343447,99,0,High Volume,Declining,577,141902,201545
4476,4335088,1150601,94,1,Unstable,Growth,512,867017,283584
4477,500000,48402,96,0,Stable,Stable,596,48402,0
4478,4989630,2012730,85,0,Stable,Stable,570,997926,1014804
4479,6010867,2186234,87,0,High Volume,Declining,549,1202173,984061
4480,1556975,326345,97,0,High Volume,Declining,582,311395,14950
4481,500000,224667,89,1,Unstable,Stable,458,100000,124667
4482,1485039,726369,93,0,Stable,Growth,618,445511,280858
4483,1883520,567004,87,0,Stable,Declining,512,376704,190300
4484,883389,269060,85,0,Low Volume,Growth,592,176677,92383
4485,1313000,241436,83,0,Unstable,Stable,487,241436,0
4486,6743949,2111043,96,1,High Volume,Growth,640,2023184,87859
4487,3375121,836487,91,0,Unstable,Stable,531,675024,161463
4488,946332,176004,92,0,High Volume,Stable,625,176004,0
4489,552341,44316,92,1,Low Volume,Growth,571,44316,0
4490,1526344,249891,98,0,Unstable,Growth,599,249891,0
4491,1671504,232397,94,0,Stable,Stable,587,232397,0
4492,2948949,866752,82,0,Stable,Stable,549,589789,276963
4493,1292058,414430,85,1,Stable,Stable,509,258411,156019
4494,2985267,966800,95,0,Stable,Growth,654,895580,71220
4495,9324195,2094974,93,0,High Volume,Stable,643,2094974,0
4496,3807186,912024,94,0,High Volume,Declining,581,761437,150587
4497,1907930,811647,96,0,Low Volume,Declining,510,381586,430061
4498,1712525,452629,95,1,Stable,Growth,595,342505,110124
4499,1490559,737078,82,1,Stable,Declining,451,298111,438967
4500,5098784,1263620,83,1,Stable,Stable,522,1019756,243864
4501,1200381,410904,97,0,Low Volume,Stable,544,240076,170828
4502,2055805,149382,97,0,Stable,Growth,628,149382,0
4503,2065656,710592,86,0,High Volume,Stable,605,619696,90896
4504,1327188,574861,96,0,Stable,Growth,640,398156,176705
4505,661343,313547,84,0,Low Volume,Stable,519,132268,181279
4506,2567337,1280573,83,0,Low Volume,Stable,535,513467,767106
4507,1888318,334195,91,0,Unstable,Stable,508,334195,0
4508,2958498,913929,86,0,Stable,Growth,613,887549,26380
4509,1293833,327111,96,0,Unstable,Growth,583,258766,68345
4510,5265344,1599179,94,0,Stable,Stable,579,1053068,546111
4511,983213,118825,89,0,High Volume,Stable,631,118825,0
4512,7799984,3395078,95,1,Stable,Growth,594,1559996,1835082
4513,500000,229653,99,0,Low Volume,Growth,616,150000,79653
4514,2807531,708474,97,1,Low Volume,Growth,582,561506,146968
4515,2900357,511024,89,0,Stable,Stable,557,511024,0
4516,1049217,118955,97,0,High Volume,Declining,583,118955,0
4517,2784323,995936,91,0,Stable,Stable,586,556864,439072
4518,5518491,1051296,92,0,Unstable,Declining,458,1051296,0
4519,500000,229646,96,1,High Volume,Growth,655,150000,79646
4520,2964432,1043348,94,0,Low Volume,Declining,488,592886,450462
4521,500000,170279,93,1,High Volume,Stable,601,150000,20279
4522,915722,276302,92,0,Unstable,Stable,517,183144,93158
4523,7299622,515349,91,0,Stable,Growth,629,515349,0
4524,1244911,584318,94,1,High Volume,Growth,652,373473,210845
4525,775215,257815,86,0,High Volume,Stable,627,232564,25251
4526,1692386,841671,89,1,Unstable,Declining,402,338477,503194
4527,10368937,3025763,81,1,Stable,Growth,572,2073787,951976
4528,500000,184775,93,2,Stable,Growth,557,100000,84775
4529,855082,64383,87,0,High Volume,Declining,570,64383,0
4530,6569481,2196055,79,1,High Volume,Growth,599,1313896,882159
4531,8763990,3453821,93,0,Stable,Growth,643,2629197,824624
4532,1825300,730725,91,0,Low Volume,Stable,554,365060,365665
4533,735833,291795,97,0,Low Volume,Stable,545,147166,144629
4534,10603289,1609867,96,1,Stable,Growth,580,1609867,0
4535,7099635,3471220,88,1,Stable,Stable,542,1419927,2051293
4536,3413189,1699195,96,0,Stable,Growth,632,1023956,675239
4537,1035172,86973,89,0,Stable,Growth,598,86973,0
4538,1906494,898723,93,3,High Volume,Growth,569,381298,517425
4539,1744035,314366,93,0,Unstable,Growth,581,314366,0
4540,2583566,930543,89,0,Stable,Growth,629,775069,155474
4541,6329939,1279597,93,1,High Volume,Growth,632,1279597,0
4542,4006921,1945318,95,1,Unstable,Growth,544,801384,1143934
4543,837435,80123,92,0,Unstable,Growth,579,80123,0
4544,5963673,1633963,92,1,Unstable,Stable,484,1192734,441229
4545,2547201,618006,94,0,Low Volume,Growth,589,509440,108566
4546,3435430,675785,90,0,High Volume,Stable,612,675785,0
4547,6409121,2182244,98,0,Unstable,Declining,479,1281824,900420
4548,814831,88796,100,0,Low Volume,Stable,574,88796,0
4549,1926739,717707,96,1,Stable,Stable,567,385347,332360
4550,1296056,636709,80,0,Unstable,Stable,492,259211,377498
4551,565640,233073,93,0,Stable,Growth,647,169692,63381
4552,2616552,1143453,91,0,Unstable,Growth,545,523310,620143
4553,14786797,3132384,97,1,Stable,Stable,543,2957359,175025
4554,500000,98099,91,0,Stable,Growth,640,98099,0
4555,1932211,546181,95,0,Stable,Growth,627,546181,0
4556,3309919,233604,96,1,Low Volume,Growth,573,233604,0
4557,2187921,1040162,87,0,Stable,Stable,574,437584,602578
4558,1811195,207750,89,0,Unstable,Stable,497,207750,0
4559,701255,320022,96,1,High Volume,Stable,610,210376,109646
4560,2388627,209272,93,0,Unstable,Growth,569,209272,0
4561,1082289,454758,98,1,Stable,Stable,556,216457,238301
4562,500000,59192,93,1,Unstable,Growth,548,59192,0
4563,5156011,346274,88,0,Stable,Growth,614,346274,0
4564,4268225,1595336,91,0,Low Volume,Stable,561,853645,741691
4565,2066421,363937,93,0,Stable,Stable,576,363937,0
4566,2381544,884799,94,0,Low Volume,Stable,542,476308,408491
4567,4683023,1403916,95,1,Stable,Growth,591,936604,467312
4568,2372540,234794,93,1,Unstable,Growth,509,234794,0
4569,4086560,1918470,96,1,Unstable,Growth,520,817312,1101158
4570,1562838,396244,85,0,Stable,Growth,589,312567,83677
4571,5663695,2155043,90,0,Stable,Stable,573,1132739,1022304
4572,2562845,705959,91,1,Stable,Growth,601,705959,0
4573,2315744,745583,91,0,High Volume,Declining,584,463148,282435
4574,717803,133689,98,0,Stable,Growth,641,133689,0
4575,2494415,349623,83,1,Low Volume,Growth,549,349623,0
4576,1019106,299777,87,0,Stable,Stable,580,203821,95956
4577,1189893,295211,95,0,Low Volume,Stable,554,237978,57233
4578,1032713,232929,99,1,Stable,Stable,538,206542,26387
4579,844933,297970,90,0,High Volume,Growth,657,253479,44491
4580,10851535,3914452,94,1,Stable,Declining,473,2170307,1744145
4581,5752075,406465,84,1,Low Volume,Stable,479,406465,0
4582,9214547,1865347,95,0,Stable,Stable,574,1842909,22438
4583,745406,175390,94,2,Stable,Growth,534,149081,26309
4584,2099066,196476,90,2,Low Volume,Growth,491,196476,0
4585,704465,110006,93,1,High Volume,Stable,602,110006,0
4586,1136477,83234,91,1,High Volume,Declining,518,83234,0
4587,951218,474000,93,0,High Volume,Declining,579,190243,283757
4588,5344974,2038844,97,1,High Volume,Stable,596,1068994,969850
4589,1444128,129037,96,0,Low Volume,Growth,603,129037,0
4590,4660827,275512,97,0,Stable,Growth,622,275512,0
4591,3214868,1201330,87,1,High Volume,Stable,566,642973,558357
4592,12520915,3100635,99,0,Stable,Stable,608,3100635,0
4593,607097,245303,96,0,Low Volume,Growth,625,182129,63174
4594,5429657,2527854,93,0,High Volume,Declining,574,1085931,1441923
4595,4961173,1586013,89,1,Stable,Growth,564,992234,593779
4596,910088,122133,87,1,High Volume,Stable,577,122133,0
4597,4437966,1784006,94,1,Stable,Growth,575,887593,896413
4598,2594530,1245674,85,0,High Volume,Growth,666,778359,467315
4599,1652862,514212,91,0,Low Volume,Growth,593,330572,183640
4600,1025665,366059,89,0,High Volume,Stable,610,307699,58360
4601,1115388,225156,84,0,High Volume,Stable,586,223077,2079
4602,10219924,2265629,87,0,Unstable,Stable,504,2043984,221645
4603,1983843,755040,91,0,Stable,Growth,632,595152,159888
4604,3706891,1732960,89,1,Stable,Stable,542,741378,991582
4605,1053133,350740,92,0,High Volume,Stable,626,315939,34801
4606,1062481,430763,83,1,Stable,Growth,568,212496,218267
4607,4711834,599514,89,0,High Volume,Declining,570,599514,0
4608,673564,97924,93,0,Low Volume,Growth,601,97924,0
4609,1422361,411653,93,0,Low Volume,Declining,510,284472,127181
4610,2037475,263750,99,0,Stable,Stable,602,263750,0
4611,2167528,727743,94,1,Low Volume,Stable,511,433505,294238
4612,1718093,311394,86,1,High Volume,Growth,631,311394,0
4613,2721397,1105403,95,0,Stable,Stable,566,544279,561124
4614,3451380,1427662,97,0,High Volume,Declining,579,690276,737386
4615,3568693,923236,96,1,High Volume,Growth,642,923236,0
4616,901087,118371,91,0,Stable,Growth,604,118371,0
4617,1579590,538717,97,0,Low Volume,Growth,591,315918,222799
4618,5156715,2561620,96,0,Stable,Growth,638,1547014,1014606
4619,4056040,1339166,98,0,Stable,Growth,632,1216812,122354
4620,661134,43700,89,0,Unstable,Stable,527,43700,0
4621,2626556,151768,93,0,Stable,Growth,635,151768,0
4622,500000,97081,83,0,Stable,Stable,566,97081,0
4623,2058623,284301,88,0,Unstable,Growth,553,284301,0
4624,9049442,3763419,92,0,High Volume,Declining,577,1809888,1953531
4625,928834,399550,86,0,High Volume,Stable,604,278650,120900
4626,1017177,169236,79,0,Stable,Declining,468,169236,0
4627,3653601,718079,89,2,Stable,Declining,431,718079,0
4628,577093,90206,97,0,High Volume,Declining,579,90206,0
4629,1195166,548309,91,2,Stable,Growth,555,239033,309276
4630,3195177,882483,83,0,High Volume,Stable,611,882483,0
4631,1193704,412140,95,0,Low Volume,Growth,588,238740,173400
4632,1641669,389021,87,0,Low Volume,Growth,561,328333,60688
4633,3596057,1200926,97,0,High Volume,Growth,679,1078817,122109
4634,2777986,621255,85,0,Stable,Growth,592,555597,65658
4635,2454552,497919,87,0,Stable,Growth,606,497919,0
4636,1511635,507178,94,1,High Volume,Stable,600,453490,53688
4637,2665891,842363,78,0,Low Volume,Growth,573,533178,309185
4638,1795895,327010,96,0,Stable,Stable,577,327010,0
4639,2859749,335182,92,0,High Volume,Declining,578,335182,0
4640,1332349,287600,95,0,Stable,Growth,624,287600,0
4641,1713322,405781,89,0,Unstable,Growth,566,342664,63117
4642,898097,298984,93,0,High Volume,Declining,559,179619,119365
4643,1928000,889845,96,1,High Volume,Declining,543,385600,504245
4644,1036333,68691,88,0,High Volume,Growth,649,68691,0
4645,813225,129829,87,1,High Volume,Growth,619,129829,0
4646,2438586,334506,100,0,High Volume,Declining,613,334506,0
4647,2350625,648849,96,0,Low Volume,Growth,604,648849,0
4648,3709097,902666,89,2,Stable,Growth,527,741819,160847
4649,1404370,530946,99,0,Stable,Growth,655,421311,109635
4650,2748160,437197,82,0,High Volume,Growth,660,437197,0
4651,3080610,978168,82,0,High Volume,Declining,553,616122,362046
4652,2830090,1267133,91,0,Unstable,Stable,505,566018,701115
4653,1024256,470958,96,0,High Volume,Growth,671,307276,163682
4654,2234417,1075767,99,0,Unstable,Declining,482,446883,628884
4655,2653293,1055924,91,0,Stable,Stable,586,530658,525266
4656,1994179,912725,94,0,Stable,Growth,632,598253,314472
4657,500000,77769,95,0,High Volume,Stable,630,77769,0
4658,2254394,313161,97,0,Stable,Stable,590,313161,0
4659,11640778,616026,94,1,Low Volume,Declining,479,616026,0
4660,1486550,547169,94,0,High Volume,Stable,646,445965,101204
4661,1107414,522545,95,0,High Volume,Stable,650,332224,190321
4662,2672911,358493,92,2,Low Volume,Growth,512,358493,0
4663,2545665,856933,92,0,Stable,Declining,542,509133,347800
4664,5148357,1986786,91,1,Stable,Stable,535,1029671,957115
4665,724839,338809,82,1,Stable,Growth,570,144967,193842
4666,3559406,1214067,84,0,Stable,Growth,587,711881,502186
4667,3179828,1547407,94,0,Stable,Stable,562,635965,911442
4668,1769633,362957,97,0,High Volume,Stable,660,362957,0
4669,2599812,539377,91,0,Low Volume,Growth,573,519962,19415
4670,4517937,1329880,90,0,Stable,Growth,602,1329880,0
4671,3984221,886791,88,1,Low Volume,Stable,488,796844,89947
4672,794592,40239,86,0,Unstable,Stable,486,40239,0
4673,3821397,1449446,88,0,High Volume,Stable,627,1146419,303027
4674,1882760,731024,86,0,Low Volume,Growth,582,376552,354472
4675,2101789,811582,89,0,Unstable,Growth,553,420357,391225
4676,2102332,431523,90,0,Low Volume,Growth,577,420466,11057
4677,1758208,501142,86,0,High Volume,Growth,639,501142,0
4678,5144126,1090493,92,1,Low Volume,Stable,491,1028825,61668
4679,1854314,106097,93,0,Low Volume,Stable,551,106097,0
4680,809655,245408,89,0,Stable,Growth,609,242896,2512
4681,1447251,152963,94,1,Stable,Growth,604,152963,0
4682,2287467,196765,94,0,Low Volume,Declining,491,196765,0
4683,5300819,2067185,99,0,High Volume,Stable,661,1590245,476940
4684,3212229,174353,91,0,Unstable,Growth,583,174353,0
4685,1004069,483513,93,0,Unstable,Stable,520,200813,282700
4686,14478161,4080886,89,0,Stable,Declining,509,2895632,1185254
4687,2450543,1206543,94,1,Low Volume,Growth,546,490108,716435
4688,5500297,418567,93,1,Stable,Declining,474,418567,0
4689,1756139,548948,92,0,High Volume,Declining,596,351227,197721
4690,3037931,629451,88,0,Unstable,Growth,545,607586,21865
4691,3880889,1667102,98,0,High Volume,Growth,696,1164266,502836
4692,5254292,1116801,97,0,High Volume,Growth,699,1116801,0
4693,4619951,772545,82,0,Low Volume,Growth,576,772545,0
4694,3983843,1736553,94,0,High Volume,Growth,663,1195152,541401
4695,1540982,336849,90,0,Stable,Growth,621,336849,0
4696,1254946,72254,94,0,Unstable,Growth,569,72254,0
4697,2587198,583750,90,0,Stable,Growth,623,583750,0
4698,4182846,1441137,84,1,High Volume,Growth,605,1254853,186284
4699,1659162,272869,89,0,High Volume,Stable,634,272869,0
4700,4648883,1136161,98,2,Unstable,Stable,474,929776,206385
4701,6338124,478667,91,1,Stable,Growth,596,478667,0
4702,952593,299726,94,1,Stable,Stable,525,190518,109208
4703,1015065,396213,81,1,High Volume,Growth,592,203013,193200
4704,1772143,418209,96,0,Unstable,Growth,565,354428,63781
4705,2535979,606364,95,0,Stable,Growth,652,606364,0
4706,1303217,116934,78,0,Stable,Declining,490,116934,0
4707,5848888,823953,93,2,Stable,Stable,508,823953,0
4708,2783594,332929,98,0,Low Volume,Declining,496,332929,0
4709,2046328,545877,89,1,High Volume,Declining,545,409265,136612
4710,628614,181145,91,1,Unstable,Growth,531,125722,55423
4711,692004,330102,94,2,High Volume,Growth,613,207601,122501
4712,2482576,205940,92,1,High Volume,Stable,589,205940,0
4713,500000,159970,88,1,High Volume,Stable,581,100000,59970
4714,4457550,1278980,89,1,High Volume,Stable,587,891510,387470
4715,1747116,493219,88,0,Stable,Growth,612,493219,0
4716,26548250,11758795,90,0,High Volume,Growth,678,7964475,3794320
4717,12563835,1790250,90,1,High Volume,Stable,575,1790250,0
4718,1714858,117207,87,1,Unstable,Stable,473,117207,0
4719,1821062,641965,97,1,Unstable,Stable,505,364212,277753
4720,4397141,902825,93,2,Stable,Stable,501,879428,23397
4721,7744846,448546,95,0,Stable,Declining,532,448546,0
4722,534762,87229,93,0,High Volume,Stable,647,87229,0
4723,500000,94599,90,0,Low Volume,Declining,506,94599,0
4724,1205460,394881,93,0,High Volume,Growth,671,361638,33243
4725,3160340,403460,87,0,Stable,Declining,507,403460,0
4726,2950540,695957,94,1,High Volume,Stable,579,590108,105849
4727,4666021,1246359,93,0,Low Volume,Growth,613,1246359,0
4728,759368,194897,87,0,Stable,Stable,557,151873,43024
4729,500000,244137,84,1,Stable,Growth,552,100000,144137
4730,3938897,277601,94,0,High Volume,Growth,680,277601,0
4731,1022175,488534,89,0,Low Volume,Growth,604,306652,181882
4732,500000,155936,95,2,High Volume,Declining,497,100000,55936
4733,2226744,908684,90,0,High Volume,Declining,583,445348,463336
4734,3739792,911300,97,1,High Volume,Growth,652,911300,0
4735,1798304,457178,90,1,Stable,Declining,479,359660,97518
4736,1374666,612684,95,0,Stable,Growth,650,412399,200285
4737,1745428,790977,86,0,High Volume,Growth,668,523628,267349
4738,1474064,232032,85,1,Stable,Declining,475,232032,0
4739,674389,94184,81,0,Stable,Declining,490,94184,0
4740,1119346,305924,90,0,Stable,Declining,527,223869,82055
4741,3008716,1369341,89,1,Low Volume,Stable,496,601743,767598
4742,2564676,500265,92,0,High Volume,Growth,689,500265,0
4743,2268088,778876,95,0,Stable,Growth,636,680426,98450
4744,894376,329728,94,1,High Volume,Declining,557,178875,150853
4745,1714784,686606,94,0,Stable,Growth,619,514435,172171
4746,500000,151883,86,0,Stable,Growth,616,150000,1883
4747,2287068,528552,94,1,Stable,Stable,543,457413,71139
4748,6218792,3017092,95,0,Stable,Declining,517,1243758,1773334
4749,609683,198207,89,0,High Volume,Growth,648,182904,15303
4750,1240789,468838,97,1,Stable,Growth,589,248157,220681
4751,2579963,529517,83,1,High Volume,Growth,597,515992,13525
4752,5401969,1898669,95,0,Stable,Growth,640,1620590,278079
4753,1385290,229971,88,0,Low Volume,Stable,514,229971,0
4754,1139614,182673,87,0,Stable,Growth,631,182673,0
4755,500000,185812,85,0,Stable,Declining,500,100000,85812
4756,2153813,613035,92,0,High Volume,Growth,673,613035,0
4757,10156869,3630821,96,0,High Volume,Growth,706,3630821,0
4758,2475336,423895,83,0,Stable,Growth,609,423895,0
4759,1947733,622156,92,0,High Volume,Growth,656,584319,37837
4760,2565505,640787,90,0,Unstable,Declining,440,513101,127686
4761,1965243,626190,85,1,Low Volume,Stable,488,393048,233142
4762,1034665,187167,95,0,Unstable,Growth,568,187167,0
4763,3830952,1424934,93,1,Unstable,Growth,531,766190,658744
4764,2375240,980186,88,0,Low Volume,Stable,521,475048,505138
4765,2010895,335744,97,0,Low Volume,Stable,542,335744,0
4766,908643,168353,99,1,Stable,Growth,591,168353,0
4767,5625421,1954943,90,0,High Volume,Growth,687,1687626,267317
4768,3374515,1224994,95,0,Low Volume,Growth,617,1012354,212640
4769,1273989,467356,96,0,High Volume,Growth,671,382196,85160
4770,4419159,1578587,89,1,Stable,Growth,595,883831,694756
4771,1331669,301974,96,0,Low Volume,Growth,595,266333,35641
4772,1060655,241494,91,0,Stable,Stable,581,212131,29363
4773,1079747,177800,94,0,Stable,Declining,540,177800,0
4774,500000,60288,93,0,High Volume,Growth,695,60288,0
4775,2891349,1045685,94,0,Low Volume,Stable,569,578269,467416
4776,500000,45967,82,0,Unstable,Growth,545,45967,0
4777,742104,350278,82,0,Stable,Growth,587,148420,201858
4778,500000,211004,95,0,High Volume,Stable,654,150000,61004
4779,1850829,806735,93,0,Stable,Stable,566,370165,436570
4780,1758099,805211,90,0,Stable,Growth,618,527429,277782
4781,1526737,357061,87,2,Stable,Declining,413,305347,51714
4782,861076,371137,95,1,High Volume,Stable,614,258322,112815
4783,776237,94024,81,0,Stable,Growth,595,94024,0
4784,2874806,171737,93,0,Low Volume,Stable,544,171737,0
4785,1276405,514648,85,0,Low Volume,Growth,582,255281,259367
4786,2553784,213646,95,0,Unstable,Stable,530,213646,0
4787,976569,483242,86,0,High Volume,Growth,649,292970,190272
4788,2291805,810516,98,0,Unstable,Growth,587,458361,352155
4789,5624386,2188181,84,0,Low Volume,Stable,515,1124877,1063304
4790,3169019,508982,98,0,Low Volume,Stable,561,508982,0
4791,1425551,503561,100,0,Stable,Stable,619,427665,75896
4792,2435735,169159,92,1,Stable,Growth,588,169159,0
4793,1635514,698400,91,0,Stable,Growth,617,490654,207746
4794,1995298,252068,92,0,Unstable,Declining,448,252068,0
4795,1528063,555926,87,0,High Volume,Stable,630,458418,97508
4796,1738498,262541,95,0,High Volume,Growth,674,262541,0
4797,2349410,189842,97,1,High Volume,Declining,562,189842,0
4798,895657,238847,95,0,Low Volume,Growth,593,179131,59716
4799,879665,110995,93,0,Low Volume,Stable,537,110995,0
4800,652891,246956,96,0,High Volume,Growth,689,195867,51089
4801,551161,86480,86,1,High Volume,Growth,599,86480,0
4802,748760,152831,87,0,High Volume,Stable,623,152831,0
4803,2252542,687808,88,0,Low Volume,Growth,595,450508,237300
4804,970697,173013,92,1,High Volume,Stable,576,173013,0
4805,2990322,658154,85,0,High Volume,Stable,610,658154,0
4806,2038594,850154,92,0,High Volume,Growth,685,611578,238576
4807,500000,65322,97,0,Unstable,Declining,476,65322,0
4808,3348357,291276,89,1,High Volume,Stable,573,291276,0
4809,3792890,750086,92,1,Unstable,Growth,530,750086,0
4810,895296,215739,93,1,Stable,Growth,592,179059,36680
4811,2774978,816389,93,0,Stable,Growth,618,816389,0
4812,999291,217436,85,1,Stable,Growth,549,199858,17578
4813,2143898,869265,87,0,Stable,Growth,619,643169,226096
4814,721005,48808,93,0,Stable,Growth,647,48808,0
4815,500000,122148,87,0,Low Volume,Growth,576,100000,22148
4816,1459707,324077,90,1,Stable,Growth,581,291941,32136
4817,1795900,613139,90,0,Unstable,Growth,580,359180,253959
4818,1442454,699337,91,0,Stable,Growth,639,432736,266601
4819,768946,215050,97,0,Low Volume,Stable,549,153789,61261
4820,1439895,711444,94,1,Low Volume,Growth,575,287979,423465
4821,2459419,457482,90,1,Stable,Growth,560,457482,0
4822,1912813,122211,84,1,Low Volume,Stable,479,122211,0
4823,2294443,285769,81,0,High Volume,Declining,541,285769,0
4824,1159974,264249,97,1,High Volume,Growth,647,264249,0
4825,5062517,973776,93,1,Stable,Stable,557,973776,0
4826,773794,72485,89,0,Low Volume,Growth,587,72485,0
4827,2928639,716629,97,0,Stable,Growth,636,716629,0
4828,5103887,1031761,92,1,Stable,Growth,599,1020777,10984
4829,2913094,306395,99,0,High Volume,Stable,646,306395,0
4830,1686187,308998,86,1,Stable,Declining,485,308998,0
4831,1299334,583266,89,0,Stable,Growth,599,259866,323400
4832,4541964,844451,97,0,High Volume,Growth,680,844451,0
4833,635152,235819,95,1,Stable,Growth,606,190545,45274
4834,912461,296934,91,1,High Volume,Declining,521,182492,114442
4835,1442595,349442,96,0,High Volume,Stable,631,349442,0
4836,5336726,840863,93,0,Stable,Growth,643,840863,0
4837,2686673,580473,92,0,High Volume,Growth,681,580473,0
4838,913979,289227,90,1,Low Volume,Growth,533,182795,106432
4839,1546885,321503,86,0,Stable,Growth,589,309377,12126
4840,1212920,177939,82,2,High Volume,Declining,446,177939,0
4841,1123735,115080,97,0,Low Volume,Declining,492,115080,0
4842,4338814,1934656,96,0,High Volume,Growth,671,1301644,633012
4843,661725,164201,89,0,Stable,Growth,626,164201,0
4844,7181542,2379559,92,0,Stable,Growth,609,2154462,225097
4845,3846152,1041094,95,0,Unstable,Growth,574,769230,271864
4846,4745414,2100581,98,0,High Volume,Declining,610,1423624,676957
4847,1369078,405412,91,1,High Volume,Declining,521,273815,131597
4848,1758633,468415,83,0,High Volume,Stable,601,468415,0
4849,630002,293625,86,0,Stable,Declining,515,126000,167625
4850,1303118,487184,86,0,High Volume,Stable,619,390935,96249
4851,2942952,294876,85,1,Stable,Growth,565,294876,0
4852,5592016,726778,89,0,Stable,Declining,529,726778,0
4853,817719,330526,90,0,High Volume,Stable,638,245315,85211
4854,1480063,630704,86,1,Unstable,Stable,464,296012,334692
4855,1756723,518823,90,0,Stable,Declining,506,351344,167479
4856,649117,194414,89,0,Stable,Stable,565,129823,64591
4857,3182187,1064027,94,1,Stable,Growth,576,636437,427590
4858,1111041,275096,91,0,High Volume,Declining,560,222208,52888
4859,1695838,603870,93,1,Stable,Growth,600,508751,95119
4860,1381169,136482,89,1,Stable,Stable,543,136482,0
4861,1054449,508851,89,1,High Volume,Stable,586,210889,297962
4862,1971616,764139,95,0,Low Volume,Growth,625,591484,172655
4863,1668628,557369,84,0,Low Volume,Growth,583,333725,223644
4864,1472561,283240,82,0,Stable,Growth,579,283240,0
4865,1107074,135539,89,0,Stable,Declining,535,135539,0
4866,2560261,599624,97,2,Stable,Stable,496,512052,87572
4867,7443813,2588285,84,1,High Volume,Growth,594,1488762,1099523
4868,2217542,743252,97,0,High Volume,Declining,572,443508,299744
4869,4399030,977414,88,0,Stable,Growth,614,977414,0
4870,652015,212543,85,0,High Volume,Stable,614,195604,16939
4871,2249479,936203,84,0,High Volume,Growth,658,674843,261360
4872,824148,50956,97,0,High Volume,Growth,684,50956,0
4873,608322,153771,89,0,Low Volume,Stable,545,121664,32107
4874,1097453,429488,95,0,High Volume,Growth,680,329235,100253
4875,5144915,1521686,98,0,High Volume,Growth,677,1521686,0
4876,4239741,1454927,88,0,Stable,Growth,607,1271922,183005
4877,2408233,680336,97,0,Stable,Declining,536,481646,198690
4878,581775,288760,84,2,High Volume,Growth,562,116355,172405
4879,1694631,126385,91,0,Unstable,Growth,573,126385,0
4880,2524011,683932,85,1,High Volume,Growth,630,683932,0
4881,2281695,207948,97,0,Unstable,Growth,589,207948,0
4882,500000,60952,99,0,High Volume,Growth,686,60952,0
4883,972617,216278,84,0,High Volume,Stable,619,216278,0
4884,1883680,226028,84,0,Unstable,Declining,459,226028,0
4885,3045065,1472774,88,0,Stable,Declining,521,609013,863761
4886,500000,238028,84,0,Low Volume,Growth,586,100000,138028
4887,1741576,350491,90,0,Low Volume,Stable,552,348315,2176
4888,2223157,751175,93,0,High Volume,Stable,639,666947,84228
4889,3912510,1135367,88,0,Low Volume,Growth,571,782502,352865
4890,3451385,1439276,88,0,High Volume,Growth,674,1035415,403861
4891,3159919,1050201,94,2,Stable,Declining,436,631983,418218
4892,1045544,52396,97,0,High Volume,Growth,709,52396,0
4893,500000,196714,88,1,Stable,Growth,591,100000,96714
4894,1447803,558970,85,0,Low Volume,Growth,575,289560,269410
4895,4418476,1234413,90,0,Stable,Growth,624,1234413,0
4896,6045130,2758475,88,0,Stable,Stable,552,1209026,1549449
4897,3500580,1606069,98,1,High Volume,Growth,654,1050174,555895
4898,2795363,798804,98,1,High Volume,Stable,585,559072,239732
4899,2686398,869304,96,0,Low Volume,Declining,524,537279,332025
4900,1270734,633378,96,0,Unstable,Growth,563,254146,379232
4901,1786827,329614,86,0,Low Volume,Growth,577,329614,0
4902,7536403,1477721,91,0,High Volume,Declining,565,1477721,0
4903,932807,123362,96,1,High Volume,Growth,641,123362,0
4904,7216084,3269897,95,0,Stable,Declining,517,1443216,1826681
4905,1532449,590023,88,0,Stable,Growth,634,459734,130289
4906,5724958,558408,96,0,Stable,Growth,658,558408,0
4907,643417,316429,94,0,Low Volume,Stable,556,128683,187746
4908,3168356,1200594,98,0,High Volume,Growth,688,950506,250088
4909,1099739,475896,98,0,High Volume,Growth,686,329921,145975
4910,639081,45802,91,0,Unstable,Growth,570,45802,0
4911,2361546,654697,90,0,Low Volume,Growth,573,472309,182388
4912,4446276,1620086,98,1,Low Volume,Growth,591,889255,730831
4913,1008573,296849,97,0,Stable,Growth,646,296849,0
4914,597666,209178,97,1,Stable,Growth,599,119533,89645
4915,1842298,770160,83,0,Low Volume,Growth,549,368459,401701
4916,1848808,403875,95,1,Stable,Stable,553,369761,34114
4917,3074509,1327883,91,0,Low Volume,Growth,600,922352,405531
4918,4238312,522636,94,0,Stable,Growth,646,522636,0
4919,1890719,325012,86,0,Unstable,Growth,540,325012,0
4920,8748586,608075,84,1,Stable,Growth,574,608075,0
4921,2372341,507662,85,0,High Volume,Growth,639,507662,0
4922,1502827,332064,94,1,High Volume,Growth,635,332064,0
4923,546203,225239,96,0,Unstable,Stable,516,109240,115999
4924,1606988,552657,97,2,Stable,Declining,444,321397,231260
4925,1514946,373472,87,0,High Volume,Stable,592,302989,70483
4926,4274783,1468180,76,0,High Volume,Declining,521,854956,613224
4927,2870472,211705,93,0,High Volume,Growth,661,211705,0
4928,771819,101203,91,0,High Volume,Growth,656,101203,0
4929,2275712,755824,93,0,Unstable,Growth,555,455142,300682
4930,3393000,1148921,93,1,Stable,Declining,483,678600,470321
4931,6732284,2681877,98,0,High Volume,Growth,701,2681877,0
4932,4032928,933017,94,0,Stable,Growth,615,933017,0
4933,3644309,1367160,89,0,Stable,Growth,608,1093292,273868
4934,2080396,744347,93,0,Unstable,Growth,565,416079,328268
4935,2705100,1307989,89,0,Low Volume,Stable,533,541020,766969
4936,5387564,790941,89,0,High Volume,Growth,652,790941,0
4937,682678,203613,98,0,Unstable,Growth,566,136535,67078
4938,1499210,480938,81,0,Low Volume,Declining,454,299842,181096
4939,1068691,533695,94,0,High Volume,Growth,695,320607,213088
4940,2685352,377380,96,1,High Volume,Declining,528,377380,0
4941,5305092,1514328,89,0,Unstable,Declining,441,1061018,453310
4942,1229872,253087,94,0,High Volume,Stable,617,253087,0
4943,500000,143326,87,0,High Volume,Growth,655,143326,0
4944,1425771,220222,95,0,Stable,Growth,635,220222,0
4945,4117592,294101,87,1,Stable,Growth,584,294101,0
4946,3048328,937832,85,0,Stable,Stable,543,609665,328167
4947,2792783,561725,95,0,Stable,Growth,622,561725,0
4948,1584858,209001,93,0,High Volume,Growth,694,209001,0
4949,712671,139520,92,0,High Volume,Growth,660,139520,0
4950,2994343,216120,93,0,Stable,Stable,584,216120,0
4951,1017210,485920,95,0,High Volume,Growth,673,305163,180757
4952,11378969,3544737,86,0,Stable,Growth,608,3413690,131047
4953,3129569,1303922,93,0,High Volume,Growth,681,938870,365052
4954,1246040,299552,98,0,Stable,Growth,646,299552,0
4955,1215774,554991,89,1,Stable,Declining,484,243154,311837
4956,1840678,492369,93,0,Unstable,Declining,455,368135,124234
4957,1637037,504658,99,0,High Volume,Growth,710,504658,0
4958,4845045,1314496,94,0,Unstable,Growth,580,969009,345487
4959,2301641,874567,95,0,Stable,Declining,538,460328,414239
4960,1104270,336797,93,0,Low Volume,Stable,555,220854,115943
4961,8996557,1549383,88,0,Low Volume,Growth,584,1549383,0
4962,2062536,238208,87,0,Unstable,Stable,514,238208,0
4963,3667687,1183768,94,0,Stable,Growth,623,1100306,83462
4964,1218851,329249,94,1,High Volume,Growth,638,329249,0
4965,2651119,247055,88,0,Stable,Stable,549,247055,0
4966,2543084,579894,93,1,Stable,Growth,569,508616,71278
4967,500000,140825,95,0,Stable,Declining,523,100000,40825
4968,9941417,4196292,87,0,Stable,Growth,612,2982425,1213867
4969,5567828,469064,88,0,High Volume,Declining,581,469064,0
4970,1443013,298448,92,0,Stable,Growth,606,298448,0
4971,820923,344948,95,0,High Volume,Growth,692,246276,98672
4972,2618335,894923,94,0,Low Volume,Stable,547,523667,371256
4973,2125161,383552,88,0,Unstable,Stable,493,383552,0
4974,2635373,1134267,86,0,Low Volume,Growth,586,527074,607193
4975,2311164,628595,92,1,Stable,Declining,479,462232,166363
4976,2972734,815297,96,0,High Volume,Declining,580,594546,220751
4977,6311252,3089133,88,0,High Volume,Growth,645,1893375,1195758
4978,3123556,1487445,91,1,Stable,Growth,582,624711,862734
4979,856214,180952,83,0,Unstable,Stable,470,171242,9710
4980,5897566,667962,96,0,Stable,Declining,535,667962,0
4981,7366783,1447941,88,0,Low Volume,Stable,518,1447941,0
4982,24683496,1572770,95,0,High Volume,Growth,690,1572770,0
4983,807102,47898,97,0,Stable,Stable,574,47898,0
4984,2407996,548987,93,0,Low Volume,Stable,567,481599,67388
4985,500000,236729,95,0,Stable,Stable,595,100000,136729
4986,3086411,1364536,84,0,Low Volume,Declining,455,617282,747254
4987,1278809,358257,97,0,Low Volume,Stable,551,255761,102496
4988,9237267,2811379,98,0,Stable,Declining,525,1847453,963926
4989,1066943,56196,93,0,Low Volume,Stable,537,56196,0
4990,513319,75445,98,0,Stable,Growth,636,75445,0
4991,1359991,83161,88,1,Stable,Growth,569,83161,0
4992,500000,194771,80,0,Stable,Stable,537,100000,94771
4993,3616002,417795,92,0,High Volume,Growth,692,417795,0
4994,500000,220536,83,0,Stable,Declining,507,100000,120536
4995,2028417,688639,90,0,Stable,Stable,581,405683,282956
4996,500000,76619,91,0,High Volume,Declining,570,76619,0
4997,1534572,185644,89,0,Stable,Growth,623,185644,0
4998,7383088,2454368,86,0,Stable,Declining,501,1476617,977751
4999,2645891,1204877,100,0,Low Volume,Stable,558,529178,675699
5000,993714,370916,82,0,Stable,Growth,609,298114,72802
5001,1933877,400015,93,1,Stable,Growth,579,386775,13240
5002,2011545,632274,86,0,Unstable,Declining,450,402309,229965
5003,2893867,549380,86,0,Stable,Declining,512,549380,0
5004,664316,331904,94,0,High Volume,Growth,679,199294,132610
5005,3185290,1232636,97,0,Low Volume,Growth,630,955587,277049
5006,500000,163236,96,0,Unstable,Declining,464,100000,63236
5007,1197914,288058,94,0,High Volume,Growth,694,288058,0
5008,1341610,440274,96,0,Low Volume,Declining,516,268322,171952
5009,3290866,670439,92,0,Stable,Growth,611,670439,0
5010,2018983,127174,95,0,High Volume,Growth,668,127174,0
5011,644062,146711,92,0,Stable,Growth,622,146711,0
5012,901671,422628,98,0,Low Volume,Declining,519,180334,242294
5013,2324334,771297,87,0,Stable,Declining,507,464866,306431
5014,1861226,163379,92,0,Stable,Growth,646,163379,0
5015,1247561,559216,93,0,High Volume,Stable,636,374268,184948
5016,1349619,230776,99,0,Low Volume,Declining,533,230776,0
5017,3460537,552635,96,0,High Volume,Declining,569,552635,0
5018,1310404,240709,88,0,High Volume,Growth,653,240709,0
5019,1847838,572351,98,0,Unstable,Declining,494,369567,202784
5020,11250794,3320218,87,0,Low Volume,Growth,597,2250158,1070060
5021,634793,172115,92,1,Stable,Stable,534,126958,45157
5022,500000,186446,95,0,High Volume,Stable,623,150000,36446
5023,3711222,714195,83,0,Stable,Stable,554,714195,0
5024,1152087,463057,90,0,Unstable,Growth,575,230417,232640
5025,1537103,198125,99,1,Stable,Stable,570,198125,0
5026,1061374,426863,97,1,High Volume,Stable,598,212274,214589
5027,1610669,561664,97,0,Unstable,Growth,578,322133,239531
5028,7122936,2546049,90,0,Low Volume,Growth,580,1424587,1121462
5029,3766673,1004568,97,0,Stable,Growth,633,1004568,0
5030,3952184,1383860,87,1,Low Volume,Declining,454,790436,593424
5031,638590,54860,94,0,High Volume,Declining,578,54860,0
5032,789438,341983,90,0,Stable,Growth,629,236831,105152
5033,500000,37498,84,1,High Volume,Declining,510,37498,0
5034,1037677,121339,93,0,Low Volume,Declining,505,121339,0
5035,4262484,1319475,95,0,Unstable,Declining,484,852496,466979
5036,2998304,1147556,93,0,Unstable,Growth,567,599660,547896
5037,1660766,140025,96,1,Stable,Stable,554,140025,0
5038,1947700,904403,91,1,Stable,Growth,573,389540,514863
5039,1142685,557771,91,0,Unstable,Stable,526,228537,329234
5040,2335665,753667,97,1,Low Volume,Declining,487,467133,286534
5041,3659008,975344,96,1,High Volume,Growth,643,975344,0
5042,544319,208816,96,0,High Volume,Stable,653,163295,45521
5043,2519871,498332,96,3,Unstable,Stable,406,498332,0
5044,4180527,1136974,97,0,Stable,Growth,623,1136974,0
5045,1422491,657572,85,0,High Volume,Growth,674,426747,230825
5046,3473108,1667248,98,0,Low Volume,Stable,545,694621,972627
5047,18844347,8803723,92,0,Low Volume,Declining,512,3768869,5034854
5048,1823970,306612,92,1,High Volume,Stable,577,306612,0
5049,2715932,419913,99,0,High Volume,Growth,694,419913,0
5050,1098608,202088,98,0,Low Volume,Growth,602,202088,0
5051,2292150,569806,88,0,High Volume,Declining,574,458430,111376
5052,2865397,548366,90,0,Unstable,Stable,519,548366,0
5053,2317209,506069,91,0,High Volume,Growth,669,506069,0
5054,876984,288779,91,0,High Volume,Stable,615,263095,25684
5055,2338662,919414,85,0,Low Volume,Growth,569,467732,451682
5056,6386882,2433410,92,0,High Volume,Declining,562,1277376,1156034
5057,2838847,1182353,86,0,High Volume,Growth,653,851654,330699
5058,4280540,276022,95,0,Low Volume,Growth,585,276022,0
5059,1640301,117249,88,0,Stable,Stable,559,117249,0
5060,3612535,1463880,91,1,Stable,Stable,548,722507,741373
5061,2479120,718661,89,0,Low Volume,Growth,567,495824,222837
5062,926595,287396,89,1,Low Volume,Growth,527,185319,102077
5063,2558206,188448,95,0,Low Volume,Growth,621,188448,0
5064,896849,147883,93,1,High Volume,Stable,590,147883,0
5065,1195047,403041,96,0,Stable,Growth,645,358514,44527
5066,2307009,1007314,97,0,Stable,Growth,655,692102,315212
5067,2515030,1163560,90,0,High Volume,Growth,667,754509,409051
5068,765752,210726,94,1,Stable,Declining,482,153150,57576
5069,4607466,1361338,89,0,High Volume,Growth,663,1361338,0
5070,3133324,1331263,99,1,Stable,Stable,575,626664,704599
5071,1128294,329384,94,0,High Volume,Stable,648,329384,0
5072,579507,163761,81,0,Stable,Stable,553,115901,47860
5073,1765733,807448,82,0,High Volume,Stable,616,529719,277729
5074,1387820,562719,91,1,Low Volume,Declining,464,277564,285155
5075,2170596,996483,86,0,High Volume,Growth,670,651178,345305
5076,1482895,219782,87,1,Low Volume,Growth,558,219782,0
5077,500000,142984,94,0,High Volume,Growth,677,142984,0
5078,1453264,623614,79,0,Stable,Stable,550,290652,332962
5079,1552698,155295,95,0,Stable,Stable,578,155295,0
5080,3291746,1341709,93,1,High Volume,Stable,604,987523,354186
5081,1134202,150098,82,0,Low Volume,Declining,460,150098,0
5082,7594537,3141506,86,0,Unstable,Stable,494,1518907,1622599
5083,500000,162700,96,0,Stable,Growth,626,150000,12700
5084,5659997,775172,91,1,High Volume,Growth,626,775172,0
5085,1657042,435818,88,0,Stable,Growth,617,435818,0
5086,3943850,1407392,91,0,Unstable,Stable,503,788770,618622
5087,2113469,708506,90,0,Stable,Growth,628,634040,74466
5088,4933920,1195298,98,1,Low Volume,Stable,528,986784,208514
5089,1454409,661341,97,0,Low Volume,Declining,494,290881,370460
5090,823323,233551,88,0,Unstable,Growth,565,164664,68887
5091,6177372,1715087,83,0,High Volume,Growth,660,1715087,0
5092,1810684,141256,91,0,Stable,Stable,555,141256,0
5093,2367267,1100671,97,0,Low Volume,Stable,546,473453,627218
5094,5324352,690582,88,0,Low Volume,Stable,532,690582,0
5095,868424,249893,89,0,High Volume,Growth,663,249893,0
5096,3192749,1314153,96,0,Low Volume,Growth,592,638549,675604
5097,1236857,181761,98,0,High Volume,Declining,583,181761,0
5098,1783814,512522,93,0,Stable,Declining,535,356762,155760
5099,2100788,332572,91,1,High Volume,Declining,548,332572,0
5100,597090,233977,92,0,Low Volume,Growth,607,179127,54850
5101,1063345,323207,96,1,High Volume,Growth,648,319003,4204
5102,5843604,2543073,96,1,Unstable,Growth,549,1168720,1374353
5103,4028695,1823190,97,0,Stable,Stable,604,1208608,614582
5104,1885848,644828,98,0,Low Volume,Declining,508,377169,267659
5105,2408462,906608,89,2,High Volume,Growth,575,481692,424916
5106,1566894,465601,93,1,Stable,Growth,570,313378,152223
5107,5869422,1308840,98,0,High Volume,Stable,662,1308840,0
5108,1689119,577093,93,0,Low Volume,Stable,534,337823,239270
5109,2386823,1094907,91,0,Stable,Declining,529,477364,617543
5110,4959543,1177922,96,0,Low Volume,Stable,558,991908,186014
5111,1064593,203853,92,0,Low Volume,Growth,609,203853,0
5112,6899996,1551096,93,0,High Volume,Growth,698,1551096,0
5113,582818,143332,99,1,Stable,Stable,558,116563,26769
5114,7302401,606848,98,1,High Volume,Declining,541,606848,0
5115,1471598,403658,94,1,High Volume,Growth,641,403658,0
5116,1632856,444858,95,0,Stable,Stable,602,444858,0
5117,500000,157400,97,0,High Volume,Growth,679,150000,7400
5118,1378028,293891,88,0,Stable,Stable,562,275605,18286
5119,862987,281246,92,1,High Volume,Growth,647,258896,22350
5120,1219416,542881,91,1,High Volume,Growth,623,365824,177057
5121,1776492,852649,100,0,Stable,Growth,657,532947,319702
5122,4266197,1333722,96,0,Stable,Growth,653,1279859,53863
5123,2340986,161916,97,1,High Volume,Growth,651,161916,0
5124,2536108,1232945,96,0,Stable,Growth,619,760832,472113
5125,825368,303437,98,0,Stable,Growth,630,247610,55827
5126,980087,197177,87,1,Stable,Declining,475,196017,1160
5127,8360092,971618,93,0,Low Volume,Stable,564,971618,0
5128,1101121,126121,84,0,Low Volume,Growth,572,126121,0
5129,7459259,936025,88,0,Stable,Stable,581,936025,0
5130,1632382,115095,97,1,Stable,Growth,621,115095,0
5131,1986392,905734,83,0,High Volume,Stable,591,397278,508456
5132,4668237,1369407,95,0,High Volume,Growth,690,1369407,0
5133,5484925,2001897,90,2,Stable,Growth,542,1096985,904912
5134,1814553,766919,94,0,Unstable,Declining,464,362910,404009
5135,1453385,590355,85,1,High Volume,Growth,630,436015,154340
5136,1896013,847845,95,1,High Volume,Growth,653,568803,279042
5137,2598295,1260861,94,0,Stable,Growth,620,779488,481373
5138,4045206,1001519,93,1,High Volume,Growth,638,1001519,0
5139,1989480,950277,90,0,Stable,Stable,570,397896,552381
5140,3253068,1221464,87,0,High Volume,Declining,581,650613,570851
5141,7353506,601522,94,0,Unstable,Growth,559,601522,0
5142,2689989,959795,91,0,Low Volume,Growth,598,537997,421798
5143,2544188,913421,97,1,High Volume,Stable,618,763256,150165
5144,588229,269196,88,0,High Volume,Growth,670,176468,92728
5145,500000,108910,87,0,Unstable,Stable,503,100000,8910
5146,2705238,847308,91,1,Low Volume,Growth,563,541047,306261
5147,1837912,101975,77,0,Unstable,Stable,464,101975,0
5148,1313458,261948,99,0,Stable,Stable,593,261948,0
5149,2409245,187944,92,0,High Volume,Growth,663,187944,0
5150,1889225,538132,93,0,Stable,Growth,618,538132,0
5151,4887660,2042316,93,1,Unstable,Growth,523,977532,1064784
5152,2124164,303541,98,0,High Volume,Growth,704,303541,0
5153,1090843,313452,96,0,Low Volume,Stable,560,218168,95284
5154,4378133,620836,87,0,Stable,Declining,524,620836,0
5155,1666598,173843,98,1,High Volume,Stable,606,173843,0
5156,3021395,845835,99,1,Stable,Declining,507,604279,241556
5157,1353320,115867,89,2,Stable,Stable,476,115867,0
5158,1178954,370557,98,0,High Volume,Growth,695,353686,16871
5159,2120865,135951,89,0,Stable,Stable,575,135951,0
5160,2003213,196358,95,0,Stable,Stable,581,196358,0
5161,2910576,865893,86,0,Low Volume,Growth,585,582115,283778
5162,1599311,505596,99,0,High Volume,Growth,716,505596,0
5163,500000,31522,86,0,Low Volume,Declining,480,31522,0
5164,1402520,432004,87,0,High Volume,Declining,541,280504,151500
5165,3741716,1598933,92,0,Stable,Growth,607,1122514,476419
5166,1562971,586180,87,0,Stable,Stable,557,312594,273586
5167,1628050,177512,91,1,Low Volume,Growth,566,177512,0
5168,4364880,1381980,88,0,High Volume,Growth,656,1309464,72516
5169,1121773,395440,97,0,High Volume,Stable,627,336531,58909
5170,577092,38523,86,0,High Volume,Stable,613,38523,0
5171,1743657,758328,97,0,Stable,Stable,598,348731,409597
5172,1346018,616234,94,0,Stable,Stable,568,269203,347031
5173,915296,396052,98,1,High Volume,Growth,642,274588,121464
5174,1723206,725615,95,0,Stable,Declining,539,344641,380974
5175,2937897,1131779,90,0,High Volume,Growth,690,881369,250410
5176,1968080,659394,91,0,High Volume,Declining,591,393616,265778
5177,2534697,900786,87,1,High Volume,Growth,608,760409,140377
5178,8458870,3492480,90,0,Unstable,Declining,446,1691774,1800706
5179,1507099,524658,93,0,Stable,Growth,614,452129,72529
5180,2477298,489210,89,1,High Volume,Stable,566,489210,0
5181,1319323,289173,99,1,Stable,Growth,613,289173,0
5182,1007429,457046,80,0,High Volume,Growth,639,302228,154818
5183,1241802,71658,85,0,Stable,Growth,587,71658,0
5184,1351862,492712,93,0,High Volume,Growth,688,405558,87154
5185,2643411,1267912,95,1,Stable,Growth,604,793023,474889
5186,12984419,4775704,87,0,Unstable,Growth,562,2596883,2178821
5187,1118127,556000,98,1,High Volume,Growth,664,335438,220562
5188,1420756,510613,92,1,Stable,Growth,586,284151,226462
5189,1885119,123406,92,1,Stable,Declining,485,123406,0
5190,2721351,1148830,90,0,Unstable,Stable,501,544270,604560
5191,2448144,435974,79,0,Unstable,Growth,541,435974,0
5192,5538735,1388703,85,1,High Volume,Growth,612,1388703,0
5193,500000,95221,91,1,Unstable,Declining,425,95221,0
5194,500000,85425,89,0,Stable,Growth,624,85425,0
5195,1333473,325544,91,0,Low Volume,Growth,586,266694,58850
5196,4769920,1051472,92,0,High Volume,Growth,663,1051472,0
5197,566641,189826,93,2,High Volume,Growth,594,113328,76498
5198,500000,207959,86,1,High Volume,Growth,598,100000,107959
5199,3131252,575179,95,0,High Volume,Stable,619,575179,0
5200,2409490,352206,89,0,Low Volume,Growth,571,352206,0
5201,828882,290194,86,0,High Volume,Growth,660,248664,41530
5202,901277,316929,92,0,High Volume,Stable,623,270383,46546
5203,912739,415761,91,0,High Volume,Declining,587,182547,233214
5204,2166077,123847,93,1,High Volume,Growth,622,123847,0
5205,1201340,521223,90,0,High Volume,Stable,628,360402,160821
5206,2943916,837400,86,0,Stable,Declining,503,588783,248617
5207,500000,164793,96,0,Unstable,Growth,577,100000,64793
5208,999008,91027,95,0,Stable,Declining,537,91027,0
5209,805450,197075,92,1,Low Volume,Growth,540,161090,35985
5210,1615132,245962,94,0,Stable,Declining,548,245962,0
5211,1289238,211952,97,0,High Volume,Stable,649,211952,0
5212,3753784,1039208,97,1,Stable,Stable,531,750756,288452
5213,500000,207803,88,1,Unstable,Growth,494,100000,107803
5214,2056247,791041,97,1,Stable,Growth,611,616874,174167
5215,3099245,979206,97,0,Stable,Declining,528,619849,359357
5216,8756597,2563390,94,1,Stable,Declining,504,1751319,812071
5217,1348613,326752,93,0,Low Volume,Growth,619,326752,0
5218,2570387,1253628,99,1,Stable,Growth,618,771116,482512
5219,500000,151043,97,0,Stable,Growth,660,150000,1043
5220,500000,82142,97,0,High Volume,Declining,588,82142,0
5221,3897397,598410,94,0,High Volume,Declining,569,598410,0
5222,1973959,641752,96,0,Stable,Growth,642,592187,49565
5223,5090111,1452068,96,0,Stable,Growth,657,1452068,0
5224,660847,35332,90,1,High Volume,Declining,522,35332,0
5225,3005401,1272876,91,0,Low Volume,Growth,594,601080,671796
5226,8842271,3243832,86,0,High Volume,Declining,544,1768454,1475378
5227,2773899,964826,88,0,Stable,Growth,625,832169,132657
5228,2473798,200257,93,0,High Volume,Growth,688,200257,0
5229,1996378,425079,92,1,Stable,Growth,569,399275,25804
5230,564274,265729,87,0,High Volume,Stable,626,169282,96447
5231,5864679,2569698,96,1,Low Volume,Growth,566,1172935,1396763
5232,1216288,217101,94,0,Low Volume,Growth,607,217101,0
5233,2968557,358235,94,0,High Volume,Stable,625,358235,0
5234,567827,143143,90,0,High Volume,Stable,614,143143,0
5235,771763,162166,86,0,Stable,Declining,495,154352,7814
5236,6249862,2231212,92,1,Stable,Stable,550,1249972,981240
5237,1501775,728204,97,0,Stable,Growth,632,450532,277672
5238,6341465,1352956,90,0,Stable,Growth,603,1352956,0
5239,1862473,145275,91,0,High Volume,Stable,614,145275,0
5240,500000,226963,93,0,Stable,Declining,540,100000,126963
5241,4047679,271508,88,0,Stable,Declining,534,271508,0
5242,1236860,592140,88,0,Unstable,Growth,566,247372,344768
5243,3467523,1210376,88,0,Low Volume,Stable,523,693504,516872
5244,2023155,958490,89,0,Low Volume,Growth,591,404631,553859
5245,576947,80684,89,0,Stable,Stable,586,80684,0
5246,2261267,154478,83,0,Stable,Growth,595,154478,0
5247,11489895,3098761,93,0,Low Volume,Declining,489,2297979,800782
5248,2941379,743523,99,0,Stable,Growth,657,743523,0
5249,1893591,377149,95,0,Stable,Growth,629,377149,0
5250,4686866,2254127,93,0,High Volume,Growth,672,1406059,848068
5251,2346733,986010,94,1,Low Volume,Stable,502,469346,516664
5252,2344605,815247,91,0,Stable,Growth,613,703381,111866
5253,827943,102074,85,1,Low Volume,Growth,530,102074,0
5254,2390656,909514,95,0,Stable,Stable,566,478131,431383
5255,4539624,1712145,92,1,High Volume,Declining,542,907924,804221
5256,1015763,245084,81,0,Unstable,Stable,483,203152,41932
5257,6197129,2888814,93,2,Stable,Growth,568,1239425,1649389
5258,1842502,230571,98,0,High Volume,Growth,705,230571,0
5259,974602,165977,94,0,Stable,Growth,629,165977,0
5260,4404361,345526,91,0,High Volume,Stable,623,345526,0
5261,1576259,643039,96,0,High Volume,Growth,681,472877,170162
5262,3640428,1200583,96,0,Stable,Stable,577,728085,472498
5263,1570011,301007,84,0,Unstable,Declining,426,301007,0
5264,1890098,233836,90,1,High Volume,Stable,560,233836,0
5265,2942730,200301,89,0,Unstable,Stable,501,200301,0
5266,2502292,312875,94,1,Low Volume,Declining,464,312875,0
5267,500000,126989,83,1,Low Volume,Growth,534,100000,26989
5268,808556,130363,86,0,Low Volume,Stable,511,130363,0
5269,4170423,694551,95,1,Stable,Stable,550,694551,0
5270,1783861,792051,88,0,High Volume,Growth,666,535158,256893
5271,1304089,367508,96,0,Stable,Declining,545,260817,106691
5272,668733,252890,86,0,Stable,Stable,550,133746,119144
5273,835855,55225,99,0,High Volume,Growth,692,55225,0
5274,500000,107162,84,2,Low Volume,Stable,431,100000,7162
5275,1828443,485682,97,0,Stable,Growth,630,485682,0
5276,1228433,164472,82,0,Low Volume,Growth,546,164472,0
5277,915046,95244,96,0,Stable,Growth,639,95244,0
5278,1877593,829214,93,0,Stable,Growth,646,563277,265937
5279,2652933,1254159,87,0,Low Volume,Stable,538,530586,723573
5280,10580871,904273,89,0,High Volume,Stable,602,904273,0
5281,591545,122484,92,0,Low Volume,Stable,553,118309,4175
5282,5012798,2412301,89,0,Stable,Stable,570,1002559,1409742
5283,4318770,377559,95,1,Low Volume,Growth,585,377559,0
5284,1063128,361079,81,0,Stable,Growth,601,318938,42141
5285,2332821,1137249,96,0,Low Volume,Growth,593,466564,670685
5286,1374903,673978,89,1,High Volume,Growth,607,412470,261508
5287,2300302,602795,88,0,Unstable,Declining,462,460060,142735
5288,6631256,817217,85,0,Low Volume,Stable,509,817217,0
5289,3218690,453636,95,0,Stable,Declining,526,453636,0
5290,2978370,1341221,81,0,Stable,Growth,580,595674,745547
5291,1405288,646794,100,0,Low Volume,Stable,556,281057,365737
5292,604861,195700,98,0,Low Volume,Growth,599,120972,74728
5293,1678188,662514,92,1,Stable,Stable,523,335637,326877
5294,5205813,1993665,84,0,High Volume,Growth,666,1561743,431922
5295,584356,203251,88,0,High Volume,Stable,619,175306,27945
5296,852500,359989,97,2,Stable,Stable,491,170500,189489
5297,2193511,786227,92,2,Low Volume,Stable,472,438702,347525
5298,901916,261827,98,2,Low Volume,Growth,541,180383,81444
5299,1051766,164738,85,1,Stable,Growth,575,164738,0
5300,1412852,543594,84,1,High Volume,Growth,601,423855,119739
5301,664976,174920,84,0,High Volume,Growth,659,174920,0
5302,909548,166135,91,2,High Volume,Stable,534,166135,0
5303,3480694,1430133,87,0,High Volume,Growth,655,1044208,385925
5304,696696,253264,94,0,High Volume,Growth,663,209008,44256
5305,552220,260539,94,1,Stable,Declining,489,110444,150095
5306,1197780,149062,90,2,Stable,Declining,442,149062,0
5307,3561044,1218358,86,0,Unstable,Growth,537,712208,506150
5308,1693762,270846,96,0,Low Volume,Growth,593,270846,0
5309,1367282,624318,93,0,High Volume,Growth,675,410184,214134
5310,2054385,194704,96,0,Low Volume,Growth,590,194704,0
5311,500000,172636,99,0,High Volume,Declining,577,100000,72636
5312,2945427,1195810,95,1,Unstable,Stable,474,589085,606725
5313,2694567,565086,88,0,Stable,Declining,497,538913,26173
5314,1429097,685055,98,1,High Volume,Growth,670,428729,256326
5315,4433676,1919023,92,0,Stable,Stable,568,886735,1032288
5316,804522,146888,84,0,Unstable,Growth,549,146888,0
5317,4888163,260996,93,0,Low Volume,Growth,609,260996,0
5318,2243606,411692,99,0,High Volume,Growth,693,411692,0
5319,1514745,267488,92,0,Stable,Stable,590,267488,0
5320,1951485,879113,96,0,Low Volume,Declining,504,390297,488816
5321,1819711,882932,94,2,Unstable,Stable,425,363942,518990
5322,5263077,429983,96,2,Unstable,Growth,491,429983,0
5323,837902,219600,93,0,Unstable,Declining,485,167580,52020
5324,1077317,319693,90,0,Stable,Stable,582,215463,104230
5325,4542746,417071,87,0,Low Volume,Stable,522,417071,0
5326,1231289,270728,91,0,Stable,Growth,604,270728,0
5327,4075184,785235,91,0,Low Volume,Stable,528,785235,0
5328,7721728,2248763,98,0,Stable,Stable,607,2248763,0
5329,1437713,499657,96,0,Stable,Stable,607,431313,68344
5330,3419791,1253587,97,1,Stable,Stable,559,683958,569629
5331,787837,87875,90,0,Low Volume,Growth,580,87875,0
5332,3626529,1508007,95,0,High Volume,Growth,674,1087958,420049
5333,2325718,826430,97,2,Unstable,Declining,416,465143,361287
5334,2894812,1302908,91,0,Stable,Stable,571,578962,723946
5335,1182974,298347,92,0,Stable,Stable,557,236594,61753
5336,524989,237426,94,2,Low Volume,Growth,503,104997,132429
5337,2965635,1303688,88,1,Stable,Declining,466,593127,710561
5338,500000,123642,89,0,Unstable,Growth,567,100000,23642
5339,1538194,340732,89,0,Stable,Declining,536,307638,33094
5340,4209883,1977657,92,0,Stable,Growth,606,1262964,714693
5341,2311757,859567,91,0,Unstable,Growth,556,462351,397216
5342,9423095,4407280,96,1,Unstable,Growth,533,1884619,2522661
5343,4502248,1839793,91,0,High Volume,Stable,615,1350674,489119
5344,1175121,380955,94,1,Stable,Growth,596,235024,145931
5345,2026561,206980,98,1,Stable,Growth,621,206980,0
5346,1909025,345851,92,0,Unstable,Declining,452,345851,0
5347,559198,271759,82,0,Stable,Stable,555,111839,159920
5348,934420,181034,94,0,Low Volume,Stable,548,181034,0
5349,1266023,116429,93,0,High Volume,Growth,682,116429,0
5350,500000,184200,92,0,Stable,Growth,643,150000,34200
5351,2059543,783248,93,0,High Volume,Growth,675,617862,165386
5352,1624552,289911,94,0,High Volume,Growth,678,289911,0
5353,520052,95665,98,1,High Volume,Growth,658,95665,0
5354,2739731,715075,94,0,High Volume,Declining,570,547946,167129
5355,3515521,210246,93,1,Unstable,Growth,511,210246,0
5356,2377661,963417,87,0,High Volume,Growth,672,713298,250119
5357,1529950,294806,92,0,Stable,Stable,558,294806,0
5358,3182424,1381787,91,0,High Volume,Growth,653,954727,427060
5359,3416668,1404878,96,0,Low Volume,Stable,577,683333,721545
5360,2535554,881437,90,0,Stable,Declining,507,507110,374327
5361,1025110,201120,98,0,High Volume,Growth,703,201120,0
5362,2473836,698469,92,0,High Volume,Growth,690,698469,0
5363,5159677,1290813,94,0,High Volume,Growth,688,1290813,0
5364,1230212,249114,87,1,Stable,Declining,463,246042,3072
5365,10621082,4584710,95,1,High Volume,Stable,580,2124216,2460494
5366,1302108,348416,90,0,High Volume,Growth,681,348416,0
5367,2034836,864247,87,0,Stable,Stable,543,406967,457280
5368,1157776,112708,82,0,High Volume,Growth,629,112708,0
5369,2370512,268961,95,1,Stable,Stable,552,268961,0
5370,500000,244897,86,0,High Volume,Stable,610,150000,94897
5371,1281019,402875,84,0,Unstable,Stable,484,256203,146672
5372,827615,231233,94,1,Stable,Growth,594,165523,65710
5373,2209486,630632,85,0,High Volume,Declining,537,441897,188735
5374,4393154,645227,96,0,High Volume,Declining,605,645227,0
5375,3324417,1241393,97,0,Stable,Declining,544,664883,576510
5376,500000,44076,97,2,Low Volume,Stable,472,44076,0
5377,10156818,3128256,98,2,Stable,Growth,552,2031363,1096893
5378,2511081,770515,87,0,High Volume,Growth,641,753324,17191
5379,1065336,491530,93,0,Stable,Stable,578,213067,278463
5380,2248339,644784,96,0,Stable,Stable,584,449667,195117
5381,2282888,254949,87,0,Stable,Stable,572,254949,0
5382,1163009,357903,96,0,Stable,Growth,622,348902,9001
5383,2322915,211612,96,1,Stable,Stable,547,211612,0
5384,1219586,172824,92,0,Low Volume,Growth,601,172824,0
5385,1434763,91823,95,0,Low Volume,Declining,523,91823,0
5386,1145070,321744,94,0,Low Volume,Growth,609,321744,0
5387,630244,55486,86,0,Stable,Growth,594,55486,0
5388,2228121,582046,84,2,Stable,Growth,509,445624,136422
5389,3166823,1487853,93,0,Stable,Growth,631,950046,537807
5390,2993359,1119195,96,0,High Volume,Stable,624,898007,221188
5391,3820685,324129,90,0,Low Volume,Growth,593,324129,0
5392,2570143,387820,80,0,Stable,Growth,592,387820,0
5393,1294739,457235,91,0,Stable,Growth,620,388421,68814
5394,3881496,1756827,92,0,Stable,Growth,629,1164448,592379
5395,669299,43380,94,0,Stable,Declining,524,43380,0
5396,964594,400888,90,0,High Volume,Declining,557,192918,207970
5397,916796,277621,99,1,High Volume,Growth,659,275038,2583
5398,4704570,1391335,87,0,Low Volume,Growth,601,1391335,0
5399,4215298,2027625,96,1,Stable,Declining,517,843059,1184566
5400,2928041,1131512,92,0,Stable,Growth,624,878412,253100
5401,4674085,2021792,98,0,High Volume,Growth,692,1402225,619567
5402,981241,205372,96,1,High Volume,Declining,537,196248,9124
5403,2620501,784745,96,0,Low Volume,Declining,522,524100,260645
5404,1793824,586459,93,0,Low Volume,Growth,588,358764,227695
5405,3903974,760154,98,0,Low Volume,Growth,601,760154,0
5406,1808161,554403,93,0,Low Volume,Declining,490,361632,192771
5407,1457227,228049,84,1,Stable,Growth,565,228049,0
5408,3056334,350008,96,0,Low Volume,Stable,544,350008,0
5409,3996523,872387,89,0,Stable,Growth,618,872387,0
5410,1161617,444528,92,0,High Volume,Declining,557,232323,212205
5411,1888209,872889,99,0,Stable,Growth,662,566462,306427
5412,850218,217631,87,1,High Volume,Growth,620,217631,0
5413,500000,169635,84,2,Stable,Declining,416,100000,69635
5414,2327645,224307,96,0,High Volume,Growth,686,224307,0
5415,3227196,1474857,87,0,Stable,Growth,601,968158,506699
5416,2445239,747930,98,0,Low Volume,Stable,545,489047,258883
5417,500000,200576,81,0,Stable,Growth,613,150000,50576
5418,1497519,610237,87,0,High Volume,Growth,646,449255,160982
5419,500000,82708,94,0,Low Volume,Growth,622,82708,0
5420,5931341,1708988,90,0,Low Volume,Growth,590,1186268,522720
5421,831641,401031,84,0,High Volume,Stable,582,166328,234703
5422,5413048,488991,89,0,Low Volume,Stable,531,488991,0
5423,4225701,1510149,91,0,Stable,Growth,621,1267710,242439
5424,964657,465948,95,0,Stable,Declining,552,192931,273017
5425,801125,148416,97,1,Unstable,Growth,537,148416,0
5426,2624225,1148496,84,1,High Volume,Stable,573,524845,623651
5427,1009071,474411,87,1,Stable,Growth,568,201814,272597
5428,2152171,831144,93,1,High Volume,Declining,544,430434,400710
5429,1347468,207642,89,1,Low Volume,Declining,463,207642,0
5430,500000,100150,96,1,Low Volume,Growth,557,100000,150
5431,500000,33057,87,0,High Volume,Growth,674,33057,0
5432,2376994,1008211,93,0,High Volume,Growth,676,713098,295113
5433,1265216,546985,88,0,Unstable,Declining,453,253043,293942
5434,1273817,426372,89,0,Unstable,Growth,553,254763,171609
5435,3459695,721822,86,0,Unstable,Stable,495,691939,29883
5436,5069505,428702,91,1,Unstable,Declining,422,428702,0
5437,1594330,619997,89,0,Stable,Growth,599,318866,301131
5438,1509850,569118,89,1,Unstable,Stable,479,301970,267148
5439,2958268,1362789,97,1,Low Volume,Declining,478,591653,771136
5440,669611,253608,80,0,High Volume,Stable,591,133922,119686
5441,2370289,1002425,93,0,Low Volume,Growth,618,711086,291339
5442,3083293,1189163,95,1,Low Volume,Growth,561,616658,572505
5443,3416695,1140524,94,0,High Volume,Growth,684,1025008,115516
5444,500000,121067,92,0,Low Volume,Stable,560,100000,21067
5445,1078321,491663,94,1,Stable,Growth,606,323496,168167
5446,982042,336777,95,0,Low Volume,Declining,516,196408,140369
5447,2147703,492382,95,0,Low Volume,Growth,609,492382,0
5448,2912713,255041,97,1,Unstable,Stable,488,255041,0
5449,6565691,1187190,92,0,High Volume,Stable,618,1187190,0
5450,1334447,393231,98,0,Low Volume,Growth,611,393231,0
5451,1331667,231758,91,0,Stable,Growth,612,231758,0
5452,4974013,743893,91,0,Low Volume,Stable,553,743893,0
5453,2513688,722251,89,0,Stable,Declining,537,502737,219514
5454,5466347,691051,87,0,Stable,Growth,609,691051,0
5455,2497954,1024622,85,0,High Volume,Growth,642,749386,275236
5456,785681,210536,95,0,Stable,Growth,622,210536,0
5457,682486,210368,96,0,Stable,Stable,584,136497,73871
5458,573086,66663,88,0,Stable,Stable,549,66663,0
5459,3367366,660204,96,0,Unstable,Growth,572,660204,0
5460,5131340,1203506,86,0,Low Volume,Growth,592,1026268,177238
5461,8705710,3601515,96,0,Stable,Declining,518,1741142,1860373
5462,3892197,1543536,94,0,Low Volume,Growth,618,1167659,375877
5463,5026683,755711,90,1,High Volume,Growth,634,755711,0
5464,1246670,408011,85,1,Stable,Stable,500,249334,158677
5465,786122,125430,91,0,Low Volume,Growth,595,125430,0
5466,3913973,1936286,96,0,High Volume,Growth,689,1174191,762095
5467,2769409,1325040,95,0,High Volume,Growth,702,1107763,217277
5468,2160727,655714,97,0,High Volume,Growth,703,655714,0
5469,2703066,985284,90,0,Unstable,Growth,563,540613,444671
5470,2567770,1054439,93,0,Stable,Growth,638,770331,284108
5471,5537499,2073513,94,1,Stable,Declining,497,1107499,966014
5472,5587198,2038897,85,0,Stable,Stable,535,1117439,921458
5473,3064443,1475068,93,0,Stable,Growth,624,919332,555736
5474,3900605,1241973,89,0,Low Volume,Stable,535,780121,461852
5475,2991394,1006114,88,0,Unstable,Declining,469,598278,407836
5476,1371018,592514,79,0,High Volume,Declining,544,274203,318311
5477,3631846,1276416,93,0,High Volume,Stable,613,1089553,186863
5478,649790,246803,99,0,High Volume,Declining,603,194937,51866
5479,4607119,715835,92,0,Stable,Stable,573,715835,0
5480,762518,165520,98,1,Stable,Growth,595,152503,13017
5481,2492116,289797,89,1,Low Volume,Declining,432,289797,0
5482,1008401,279927,94,0,Low Volume,Stable,532,201680,78247
5483,3087003,787424,97,0,Stable,Stable,571,617400,170024
5484,1929670,962371,96,1,Stable,Declining,513,385934,576437
5485,553599,179944,88,0,Stable,Growth,621,166079,13865
5486,2776106,1121270,93,1,Low Volume,Growth,547,555221,566049
5487,1248762,250135,94,0,Stable,Stable,583,249752,383
5488,4012469,1702071,96,2,Low Volume,Growth,512,802493,899578
5489,1984863,648630,85,0,Low Volume,Growth,568,396972,251658
5490,2720529,989311,90,0,Unstable,Growth,555,544105,445206
5491,921672,168199,88,0,Low Volume,Declining,475,168199,0
5492,1237414,367372,90,0,Stable,Growth,638,367372,0
5493,1373797,460657,93,0,Low Volume,Stable,548,274759,185898
5494,3934766,1239816,99,0,Stable,Growth,649,1180429,59387
5495,7586657,3503800,88,0,Low Volume,Stable,531,1517331,1986469
5496,1041177,472926,95,1,Unstable,Growth,521,208235,264691
5497,4692512,2284985,95,0,Stable,Stable,569,938502,1346483
5498,500000,175171,94,0,Low Volume,Growth,619,150000,25171
5499,762722,371721,76,0,High Volume,Stable,559,152544,219177
5500,920781,390978,93,0,Stable,Growth,609,276234,114744
5501,671986,115497,83,0,Stable,Growth,595,115497,0
5502,558567,135367,99,1,High Volume,Stable,627,135367,0
5503,2759056,433935,96,0,Low Volume,Declining,500,433935,0
5504,1670688,86690,97,0,Stable,Growth,629,86690,0
5505,2685894,361580,93,1,Low Volume,Stable,500,361580,0
5506,3444806,178535,86,0,Low Volume,Growth,565,178535,0
5507,2452194,916942,85,0,Stable,Stable,559,490438,426504
5508,3355833,810402,85,0,Low Volume,Growth,566,671166,139236
5509,1875478,357576,98,0,Stable,Declining,535,357576,0
5510,767125,301307,90,0,Stable,Growth,632,230137,71170
5511,4621599,1962419,90,0,Low Volume,Growth,587,924319,1038100
5512,1237632,605059,89,2,Stable,Stable,502,247526,357533
5513,938017,317900,88,0,High Volume,Declining,583,187603,130297
5514,1719709,443148,94,0,Low Volume,Stable,563,343941,99207
5515,955272,178988,97,0,Stable,Growth,660,178988,0
5516,1419841,213037,91,0,High Volume,Stable,606,213037,0
5517,2610998,380727,92,0,Low Volume,Growth,615,380727,0
5518,2619970,613427,84,0,Stable,Growth,608,613427,0
5519,966789,479821,93,1,Stable,Stable,547,193357,286464
5520,1342220,67627,94,1,Stable,Growth,573,67627,0
5521,4683079,649743,98,2,Low Volume,Growth,525,649743,0
5522,2949423,397514,94,1,Stable,Growth,612,397514,0
5523,10428490,3886738,98,0,Stable,Declining,542,2085698,1801040
5524,5096693,1063263,95,1,High Volume,Stable,593,1019338,43925
5525,4952655,1266728,97,0,Stable,Declining,546,990531,276197
5526,653243,76352,97,0,Stable,Growth,641,76352,0
5527,3653106,848429,93,0,High Volume,Stable,630,848429,0
5528,1900285,183263,94,1,Stable,Stable,558,183263,0
5529,1275967,369864,92,0,Low Volume,Growth,614,369864,0
5530,2268008,213357,85,0,Stable,Growth,596,213357,0
5531,4223477,1713586,94,1,Stable,Stable,541,844695,868891
5532,2959898,902682,85,0,Unstable,Stable,510,591979,310703
5533,981877,368975,91,1,Low Volume,Growth,533,196375,172600
5534,3591093,855874,91,0,High Volume,Growth,659,855874,0
5535,1190555,263912,96,0,Low Volume,Stable,572,238111,25801
5536,2358052,222114,87,0,High Volume,Growth,652,222114,0
5537,1555519,444466,90,0,High Volume,Growth,681,444466,0
5538,1664286,468540,89,0,High Volume,Declining,571,332857,135683
5539,3660076,953984,94,1,Stable,Declining,479,732015,221969
5540,862720,330623,89,0,Stable,Growth,611,258816,71807
5541,9399397,3991238,87,1,Low Volume,Growth,561,1879879,2111359
5542,500000,193928,98,0,High Volume,Growth,711,193928,0
5543,1229190,141037,94,0,High Volume,Growth,677,141037,0
5544,2666213,879655,93,0,Stable,Growth,615,799863,79792
5545,3164328,272592,88,0,Stable,Growth,632,272592,0
5546,1829621,663384,93,0,High Volume,Declining,598,365924,297460
5547,1893784,420094,91,1,Unstable,Growth,527,378756,41338
5548,2753656,301868,87,0,Low Volume,Growth,593,301868,0
5549,1648118,721749,94,0,Stable,Stable,566,329623,392126
5550,6043809,1972118,96,0,Stable,Stable,597,1208761,763357
5551,3880518,813458,99,0,Stable,Growth,628,813458,0
5552,3985843,254405,97,0,Stable,Growth,654,254405,0
5553,915362,267093,86,0,Stable,Growth,601,267093,0
5554,1860748,866088,83,1,Stable,Growth,548,372149,493939
5555,1559112,496376,94,0,Stable,Growth,650,467733,28643
5556,886928,432149,99,0,Stable,Growth,647,266078,166071
5557,2644867,294646,94,0,Stable,Growth,636,294646,0
5558,1289653,394295,92,0,High Volume,Growth,692,386895,7400
5559,3349505,1370471,90,0,High Volume,Growth,688,1004851,365620
5560,842262,241302,83,0,High Volume,Stable,609,241302,0
5561,7843788,713627,96,0,Stable,Declining,531,713627,0
5562,967948,302289,96,1,Unstable,Stable,472,193589,108700
5563,2362998,768641,86,0,Stable,Growth,612,708899,59742
5564,3735856,1411852,88,0,High Volume,Growth,645,1120756,291096
5565,1256057,493059,94,1,High Volume,Stable,606,376817,116242
5566,3921461,1556223,99,1,Stable,Growth,606,1176438,379785
5567,741665,258507,94,2,Unstable,Growth,481,148333,110174
5568,6335594,932061,85,0,Unstable,Stable,514,932061,0
5569,2005330,465048,96,0,High Volume,Growth,673,465048,0
5570,1230426,491258,85,0,Low Volume,Stable,537,246085,245173
5571,1560715,747648,89,0,High Volume,Declining,560,312143,435505
5572,3787192,323904,96,2,Low Volume,Growth,533,323904,0
5573,1242251,361484,84,1,Low Volume,Stable,483,248450,113034
5574,1088721,207548,95,0,High Volume,Declining,578,207548,0
5575,1660735,251481,89,0,High Volume,Stable,632,251481,0
5576,773306,214681,92,0,High Volume,Stable,628,214681,0
5577,8507300,2745648,92,0,Stable,Growth,621,2552190,193458
5578,1260330,68559,89,1,High Volume,Declining,531,68559,0
5579,3856588,1546850,85,1,Stable,Growth,563,771317,775533
5580,2344484,982214,94,1,Stable,Growth,582,468896,513318
5581,902003,437002,93,0,Stable,Declining,538,180400,256602
5582,1973336,259079,96,0,Stable,Growth,642,259079,0
5583,3712449,1178883,88,0,Unstable,Stable,514,742489,436394
5584,1705538,412709,98,0,High Volume,Stable,640,412709,0
5585,5149913,1033446,97,0,Low Volume,Growth,616,1033446,0
5586,4489322,1367156,82,2,Stable,Growth,501,897864,469292
5587,4135554,1662792,89,0,Stable,Growth,607,1240666,422126
5588,1372679,82874,91,0,Stable,Declining,503,82874,0
5589,835784,406383,88,0,High Volume,Stable,606,250735,155648
5590,1213634,502987,93,0,Stable,Declining,524,242726,260261
5591,2319803,900128,93,0,Unstable,Growth,559,463960,436168
5592,3068285,1203303,89,0,Unstable,Stable,508,613657,589646
5593,500000,112539,91,0,Stable,Growth,638,112539,0
5594,1969932,764785,99,0,Stable,Growth,658,590979,173806
5595,2250069,504120,87,0,Stable,Growth,593,450013,54107
5596,1587966,721600,95,0,Low Volume,Stable,561,317593,404007
5597,5570632,722790,94,0,High Volume,Stable,627,722790,0
5598,2778506,504455,94,0,Stable,Growth,648,504455,0
5599,5655582,1685940,78,0,Stable,Growth,590,1131116,554824
5600,1668160,323031,98,0,Low Volume,Stable,578,323031,0
5601,4197426,1011188,91,0,High Volume,Stable,604,1011188,0
5602,7334158,1991886,99,0,Stable,Growth,644,1991886,0
5603,5662379,2465168,99,1,Stable,Growth,611,1698713,766455
5604,827601,236228,90,0,Stable,Growth,635,236228,0
5605,1618579,344930,96,0,High Volume,Growth,686,344930,0
5606,1504345,242924,84,0,Low Volume,Growth,576,242924,0
5607,2932611,685950,95,0,Stable,Growth,653,685950,0
5608,3433473,968518,93,0,Stable,Stable,579,686694,281824
5609,1013465,390946,93,0,Unstable,Declining,486,202693,188253
5610,2093339,218695,96,0,Stable,Stable,607,218695,0
5611,500000,74862,85,0,Low Volume,Declining,466,74862,0
5612,6284243,1387839,92,0,Stable,Stable,584,1256848,130991
5613,1315991,279226,95,0,Stable,Growth,621,279226,0
5614,2073381,469178,91,0,High Volume,Growth,681,469178,0
5615,1547700,630045,89,0,Unstable,Growth,568,309540,320505
5616,4959533,971421,87,0,High Volume,Growth,651,971421,0
5617,500000,137927,93,0,Stable,Stable,595,100000,37927
5618,1956586,647157,84,0,Low Volume,Stable,516,391317,255840
5619,1821817,281435,97,0,Stable,Growth,646,281435,0
5620,1379306,515051,98,1,High Volume,Stable,585,275861,239190
5621,7889010,2336726,83,0,Unstable,Declining,447,1577802,758924
5622,974945,244761,90,0,High Volume,Growth,653,244761,0
5623,3676372,1523499,92,1,High Volume,Growth,649,1102911,420588
5624,2636604,420730,90,0,High Volume,Growth,684,420730,0
5625,5439596,2433834,93,0,Stable,Growth,618,1631878,801956
5626,1162692,351682,91,0,Unstable,Growth,576,232538,119144
5627,1103089,357543,99,0,Unstable,Growth,590,220617,136926
5628,4765228,2114696,85,0,Stable,Declining,524,953045,1161651
5629,2786389,1164466,92,0,Low Volume,Declining,505,557277,607189
5630,576108,184760,93,1,Low Volume,Stable,493,115221,69539
5631,1287942,500925,99,0,Stable,Stable,581,257588,243337
5632,2700928,661711,94,1,Low Volume,Declining,451,540185,121526
5633,3875601,1148418,82,0,Stable,Declining,510,775120,373298
5634,1151545,89742,91,0,High Volume,Stable,613,89742,0
5635,500000,45218,89,1,Stable,Growth,573,45218,0
5636,3013397,1275394,97,0,High Volume,Growth,671,904019,371375
5637,746942,57404,91,0,Unstable,Growth,578,57404,0
5638,500000,63115,96,0,Low Volume,Stable,543,63115,0
5639,500000,204062,94,1,High Volume,Growth,651,150000,54062
5640,3802559,192089,95,1,High Volume,Growth,659,192089,0
5641,2197639,389162,90,0,Unstable,Growth,552,389162,0
5642,1655270,517797,93,2,Low Volume,Growth,499,331054,186743
5643,6023744,1915264,97,0,Stable,Stable,593,1204748,710516
5644,3301408,1319635,92,0,High Volume,Growth,668,990422,329213
5645,7224872,2006107,96,0,High Volume,Stable,651,2006107,0
5646,650705,181697,90,0,Stable,Growth,615,181697,0
5647,1928705,725945,92,0,Low Volume,Declining,486,385741,340204
5648,543959,149252,84,0,High Volume,Declining,558,108791,40461
5649,1650344,534416,83,1,High Volume,Stable,567,330068,204348
5650,1625145,737813,81,0,Stable,Stable,523,325029,412784
5651,3273240,754982,91,0,Stable,Stable,574,654648,100334
5652,2056366,459199,90,1,Unstable,Declining,440,411273,47926
5653,3264854,168457,85,1,Low Volume,Stable,489,168457,0
5654,3480728,1134863,98,0,Stable,Stable,580,696145,438718
5655,11116521,704758,85,0,Low Volume,Growth,575,704758,0
5656,1540724,426575,90,1,Stable,Growth,585,308144,118431
5657,933953,384700,95,0,High Volume,Stable,632,280185,104515
5658,2414172,718130,94,0,High Volume,Declining,594,482834,235296
5659,1043589,178805,88,0,High Volume,Stable,617,178805,0
5660,6488673,2619969,80,0,Unstable,Stable,469,1297734,1322235
5661,1580775,270902,98,0,Unstable,Stable,526,270902,0
5662,1261155,479068,92,0,High Volume,Declining,586,252231,226837
5663,1359935,441457,83,0,Stable,Declining,496,271987,169470
5664,3522685,445614,98,0,Stable,Declining,534,445614,0
5665,1747685,799234,98,1,Stable,Growth,615,524305,274929
5666,1186676,166478,97,0,Stable,Stable,591,166478,0
5667,7514023,3721802,89,0,High Volume,Stable,637,2254206,1467596
5668,999554,53266,97,1,Low Volume,Growth,576,53266,0
5669,2039985,343875,99,0,Unstable,Growth,574,343875,0
5670,3341214,467560,94,0,High Volume,Growth,678,467560,0
5671,537633,30267,93,0,High Volume,Growth,694,30267,0
5672,2911586,1105138,97,0,Stable,Stable,592,582317,522821
5673,852488,308636,99,0,Low Volume,Growth,605,255746,52890
5674,3829429,1556885,92,0,High Volume,Growth,660,1148828,408057
5675,917933,151931,96,0,Stable,Stable,581,151931,0
5676,3451140,862615,96,0,Low Volume,Declining,498,690228,172387
5677,4802593,1664584,96,0,High Volume,Growth,698,1440777,223807
5678,3949696,979113,80,0,High Volume,Declining,526,789939,189174
5679,2424300,881952,98,0,Unstable,Stable,552,484860,397092
5680,1647813,552492,94,0,Low Volume,Stable,552,329562,222930
5681,1250263,127016,89,0,Stable,Growth,625,127016,0
5682,6432204,2582333,91,0,High Volume,Declining,563,1286440,1295893
5683,1133028,424097,94,0,Low Volume,Growth,619,339908,84189
5684,864881,298492,92,0,Stable,Stable,568,172976,125516
5685,3376314,404456,89,1,High Volume,Stable,596,404456,0
5686,1048730,178912,91,0,Stable,Stable,577,178912,0
5687,927223,210414,93,0,Unstable,Declining,484,185444,24970
5688,624756,109937,82,0,Unstable,Growth,552,109937,0
5689,1347379,205495,92,0,Stable,Growth,635,205495,0
5690,1855803,765353,95,0,Unstable,Stable,532,371160,394193
5691,2408400,812123,85,0,Stable,Growth,588,481680,330443
5692,4244120,1292175,94,0,High Volume,Stable,652,1273236,18939
5693,3022269,458414,93,0,High Volume,Stable,628,458414,0
5694,1701979,788245,85,0,Stable,Growth,596,340395,447850
5695,1692037,230172,96,1,Low Volume,Growth,560,230172,0
5696,2982063,1215870,87,1,High Volume,Growth,626,894618,321252
5697,5487899,2661646,91,1,High Volume,Stable,600,1646369,1015277
5698,2193593,827405,91,1,Stable,Growth,598,438718,388687
5699,1362314,676779,95,0,High Volume,Stable,637,408694,268085
5700,896010,307307,93,1,Stable,Declining,488,179202,128105
5701,623956,92256,96,0,High Volume,Growth,670,92256,0
5702,3378748,478832,91,1,Stable,Growth,573,478832,0
5703,3148330,617242,90,0,Unstable,Growth,569,617242,0
5704,3146782,167436,95,1,Low Volume,Stable,504,167436,0
5705,1788830,638191,75,0,High Volume,Declining,517,357766,280425
5706,6110675,1044317,93,0,Stable,Growth,618,1044317,0
5707,1346077,561089,91,1,High Volume,Growth,643,403823,157266
5708,4257597,901025,92,0,High Volume,Stable,642,901025,0
5709,1922248,511280,96,0,Stable,Declining,542,384449,126831
5710,1218729,590547,96,0,Stable,Declining,546,243745,346802
5711,3185196,506374,87,0,High Volume,Growth,661,506374,0
5712,2751643,1030667,98,0,Stable,Stable,588,550328,480339
5713,2638123,1028348,95,0,Stable,Stable,575,527624,500724
5714,2115968,316230,91,2,Stable,Stable,506,316230,0
5715,1923555,529840,86,0,Stable,Stable,548,384711,145129
5716,13399093,2781529,98,0,Low Volume,Growth,601,2781529,0
5717,5113554,2031911,97,1,Stable,Growth,614,1534066,497845
5718,3535133,1167009,96,0,Stable,Stable,608,1060539,106470
5719,2168268,572840,97,0,High Volume,Stable,646,572840,0
5720,4438050,1778386,95,1,Low Volume,Growth,565,887610,890776
5721,3000819,467588,97,1,Stable,Growth,604,467588,0
5722,2024764,787896,84,0,Stable,Declining,513,404952,382944
5723,1555253,683407,97,0,Stable,Stable,588,311050,372357
5724,1858474,827727,91,0,Low Volume,Stable,548,371694,456033
5725,500000,201327,85,0,Stable,Growth,625,150000,51327
5726,2346606,548182,91,0,Stable,Growth,618,548182,0
5727,1341393,659715,93,0,High Volume,Stable,649,402417,257298
5728,7089575,1565500,95,0,Unstable,Stable,541,1417915,147585
5729,2013682,679379,96,0,Stable,Stable,587,402736,276643
5730,765917,93812,92,0,High Volume,Growth,670,93812,0
5731,1905197,935837,91,0,Stable,Stable,556,381039,554798
5732,858638,314943,87,1,Stable,Growth,590,171727,143216
5733,2895667,1126472,96,0,Stable,Stable,583,579133,547339
5734,2502393,199189,93,0,Unstable,Declining,460,199189,0
5735,4266361,1678975,85,0,Stable,Growth,619,1279908,399067
5736,1053148,419812,89,0,Unstable,Growth,562,210629,209183
5737,2037444,717787,79,0,Low Volume,Declining,445,407488,310299
5738,665293,120657,89,1,Unstable,Stable,462,120657,0
5739,3475316,939588,84,0,High Volume,Growth,646,939588,0
5740,3002924,299378,89,0,High Volume,Growth,666,299378,0
5741,2948019,773012,99,0,Stable,Stable,579,589603,183409
5742,1985329,317098,95,0,Stable,Stable,569,317098,0
5743,2762974,572194,96,1,High Volume,Stable,617,572194,0
5744,7156068,881414,93,1,High Volume,Growth,657,881414,0
5745,1578404,242324,95,0,High Volume,Stable,627,242324,0
5746,2215339,187098,90,0,Stable,Growth,628,187098,0
5747,831593,385822,95,1,Unstable,Declining,421,166318,219504
5748,989932,285778,91,0,Stable,Declining,510,197986,87792
5749,2144143,490009,83,0,Stable,Stable,555,428828,61181
5750,4795300,1394297,86,0,Low Volume,Declining,466,959060,435237
5751,1615210,537432,91,0,Stable,Growth,634,484563,52869
5752,1641739,763155,94,0,Stable,Growth,647,492521,270634
5753,1431870,186733,91,0,High Volume,Growth,688,186733,0
5754,1292637,236551,89,2,Unstable,Stable,444,236551,0
5755,2510462,1227880,93,1,Stable,Stable,557,502092,725788
5756,598507,129898,93,0,Stable,Stable,569,119701,10197
5757,5524767,332330,94,1,Stable,Declining,507,332330,0
5758,1164337,135575,91,0,Low Volume,Declining,479,135575,0
5759,3532523,218495,96,0,High Volume,Stable,656,218495,0
5760,717839,355664,96,1,Stable,Stable,548,143567,212097
5761,3385703,594163,96,0,High Volume,Growth,682,594163,0
5762,3394122,1580284,95,1,High Volume,Declining,548,678824,901460
5763,2696221,1343119,84,0,Stable,Growth,622,808866,534253
5764,894891,286301,96,0,Stable,Stable,590,178978,107323
5765,2420872,157207,96,0,Low Volume,Growth,596,157207,0
5766,769545,66732,92,0,Unstable,Growth,557,66732,0
5767,1619761,432015,93,1,Low Volume,Stable,496,323952,108063
5768,4517776,1051636,96,0,Stable,Growth,639,1051636,0
5769,3750357,1210539,93,0,Stable,Stable,592,750071,460468
5770,2006989,496693,91,1,Stable,Stable,532,401397,95296
5771,909049,427557,97,2,High Volume,Growth,622,272714,154843
5772,3323304,965861,99,0,Unstable,Growth,579,664660,301201
5773,2013741,729330,90,1,Unstable,Growth,538,402748,326582
5774,500000,226709,90,1,Unstable,Stable,469,100000,126709
5775,3708373,430514,94,0,Stable,Declining,519,430514,0
5776,1944691,298278,87,1,Stable,Growth,556,298278,0
5777,5188530,509998,91,1,Low Volume,Stable,517,509998,0
5778,825532,93151,92,0,Stable,Growth,638,93151,0
5779,500000,140331,98,0,Low Volume,Declining,518,100000,40331
5780,2478755,482194,88,0,High Volume,Declining,557,482194,0
5781,2503627,601941,93,0,Low Volume,Growth,611,601941,0
5782,512708,252314,92,0,Low Volume,Stable,565,102541,149773
5783,906368,109233,86,0,High Volume,Declining,553,109233,0
5784,17969280,5271566,89,0,Stable,Growth,634,5271566,0
5785,1552709,146719,96,2,Low Volume,Growth,548,146719,0
5786,3558206,687884,97,0,Unstable,Declining,498,687884,0
5787,1178169,338590,86,0,Low Volume,Growth,560,235633,102957
5788,500000,237992,88,0,Unstable,Growth,571,100000,137992
5789,1730279,391134,97,0,Unstable,Declining,470,346055,45079
5790,1603207,126987,92,0,Unstable,Stable,528,126987,0
5791,1439919,323510,90,0,Stable,Growth,615,323510,0
5792,1809005,209091,84,0,High Volume,Stable,612,209091,0
5793,2449549,375994,88,1,Stable,Declining,478,375994,0
5794,1758385,576998,87,0,High Volume,Growth,654,527515,49483
5795,721289,57949,98,0,Stable,Growth,631,57949,0
5796,2925418,758051,93,1,Stable,Stable,527,585083,172968
5797,500000,162129,93,0,Low Volume,Growth,591,100000,62129
5798,500000,119918,96,0,Stable,Declining,531,100000,19918
5799,3581687,209911,95,0,Stable,Stable,579,209911,0
5800,2974588,1467911,98,0,Unstable,Stable,518,594917,872994
5801,1893777,407545,92,0,Stable,Growth,644,407545,0
5802,649294,259951,96,0,Stable,Growth,630,194788,65163
5803,1125425,221192,94,0,Low Volume,Growth,584,221192,0
5804,1606876,423826,91,0,High Volume,Declining,585,321375,102451
5805,553095,124341,90,0,High Volume,Growth,668,124341,0
5806,1097754,224098,78,0,Stable,Growth,594,219550,4548
5807,3341279,199919,95,0,Stable,Stable,596,199919,0
5808,6211073,1316806,94,1,Stable,Stable,523,1242214,74592
5809,1417566,638288,96,0,Unstable,Stable,523,283513,354775
5810,3631625,1309844,93,0,Stable,Growth,613,1089487,220357
5811,500000,57720,93,0,Unstable,Growth,586,57720,0
5812,3360368,1061943,86,2,High Volume,Growth,587,672073,389870
5813,1042197,470556,95,1,Stable,Declining,492,208439,262117
5814,2535437,925473,94,1,Stable,Growth,607,760631,164842
5815,1626267,190124,90,0,High Volume,Growth,690,190124,0
5816,5702021,2511881,91,0,Stable,Growth,640,1710606,801275
5817,985054,182919,90,0,Low Volume,Growth,597,182919,0
5818,3275841,833159,93,0,Low Volume,Declining,511,655168,177991
5819,1585474,454657,96,0,High Volume,Growth,669,454657,0
5820,1746904,755934,93,0,Stable,Growth,610,524071,231863
5821,1711562,803105,90,0,Stable,Declining,531,342312,460793
5822,1007983,472083,91,0,Low Volume,Growth,584,201596,270487
5823,1960521,105044,96,1,High Volume,Growth,666,105044,0
5824,1885835,876630,98,1,Stable,Stable,539,377167,499463
5825,2404836,179098,88,0,High Volume,Declining,558,179098,0
5826,2121437,359792,84,0,Stable,Declining,513,359792,0
5827,3754237,1057736,90,0,High Volume,Stable,614,1057736,0
5828,4150780,1103969,98,0,Stable,Declining,533,830156,273813
5829,855551,275590,96,0,Stable,Growth,632,256665,18925
5830,3972944,1055813,90,0,Low Volume,Growth,602,1055813,0
5831,767528,361098,99,0,High Volume,Growth,715,307011,54087
5832,3173307,502166,94,1,Stable,Growth,606,502166,0
5833,3255287,564177,84,1,Stable,Stable,503,564177,0
5834,500000,232166,84,0,Low Volume,Declining,488,100000,132166
5835,2135867,180551,88,1,Stable,Stable,538,180551,0
5836,1363006,442026,92,0,Unstable,Declining,449,272601,169425
5837,1080558,385523,91,0,High Volume,Stable,612,324167,61356
5838,5842573,1621278,88,0,Stable,Declining,513,1168514,452764
5839,1175327,425944,81,0,Stable,Stable,553,235065,190879
5840,1040174,132871,93,0,Stable,Stable,589,132871,0
5841,2106537,913572,99,0,Low Volume,Growth,627,631961,281611
5842,3431376,387785,94,0,High Volume,Declining,581,387785,0
5843,1770338,407825,96,0,Stable,Declining,526,354067,53758
5844,5040906,422760,95,0,Stable,Declining,527,422760,0
5845,3032144,895529,93,1,Stable,Stable,555,606428,289101
5846,500000,175693,98,0,Stable,Stable,614,150000,25693
5847,1298118,614723,96,0,High Volume,Growth,691,389435,225288
5848,1264929,484090,95,0,Stable,Growth,639,379478,104612
5849,2909491,853925,97,0,High Volume,Growth,700,853925,0
5850,500000,234839,86,1,Low Volume,Growth,541,100000,134839
5851,15236551,4042205,90,1,Stable,Growth,568,3047310,994895
5852,3032266,917389,95,0,Stable,Declining,543,606453,310936
5853,2233547,710814,87,0,High Volume,Declining,550,446709,264105
5854,5102566,1196505,86,0,High Volume,Stable,601,1196505,0
5855,12928222,5524452,89,0,High Volume,Growth,668,3878466,1645986
5856,3979224,530547,94,0,Low Volume,Growth,593,530547,0
5857,4235663,1269339,92,0,Stable,Declining,513,847132,422207
5858,2201285,825493,98,0,Stable,Declining,526,440257,385236
5859,1770512,808751,87,1,Low Volume,Growth,546,354102,454649
5860,1355070,606751,88,1,High Volume,Growth,623,406521,200230
5861,1023881,285594,89,0,High Volume,Declining,563,204776,80818
5862,1144397,388434,86,1,Low Volume,Declining,448,228879,159555
5863,673037,153053,91,1,High Volume,Declining,525,134607,18446
5864,1865991,486427,86,0,High Volume,Growth,669,486427,0
5865,515177,235858,93,1,Stable,Stable,524,103035,132823
5866,2309943,1082940,87,1,Unstable,Declining,422,461988,620952
5867,1925961,872338,92,0,High Volume,Growth,687,577788,294550
5868,2230080,250364,96,0,High Volume,Growth,699,250364,0
5869,1305759,564790,95,2,Unstable,Stable,425,261151,303639
5870,23242389,11081127,98,0,Stable,Growth,664,6972716,4108411
5871,5886032,1251149,86,0,High Volume,Declining,548,1177206,73943
5872,732608,207614,91,1,High Volume,Declining,524,146521,61093
5873,2388783,956929,92,0,Stable,Growth,626,716634,240295
5874,1219065,369298,93,0,High Volume,Stable,629,365719,3579
5875,880651,437743,87,0,Stable,Stable,550,176130,261613
5876,678705,173118,87,0,Stable,Growth,599,135741,37377
5877,2801802,1040237,97,0,Low Volume,Growth,602,840540,199697
5878,1149567,467490,92,0,Stable,Stable,587,229913,237577
5879,4300582,1171243,82,0,Stable,Growth,596,860116,311127
5880,4390817,1912827,90,0,Unstable,Stable,507,878163,1034664
5881,5951367,1760233,97,0,High Volume,Stable,661,1760233,0
5882,1002583,235850,99,1,High Volume,Stable,625,235850,0
5883,2900206,285730,94,0,Unstable,Stable,506,285730,0
5884,3288570,746624,85,0,High Volume,Declining,539,657714,88910
5885,1356824,515961,97,0,Low Volume,Growth,597,271364,244597
5886,1069372,496808,90,0,Low Volume,Declining,483,213874,282934
5887,7185794,1173122,81,2,Stable,Declining,433,1173122,0
5888,2378538,499150,94,0,Low Volume,Stable,553,475707,23443
5889,3297827,393373,97,1,High Volume,Growth,663,393373,0
5890,1027192,370637,95,0,Low Volume,Declining,519,205438,165199
5891,747562,360388,87,0,Low Volume,Stable,539,149512,210876
5892,1257254,425491,92,0,High Volume,Declining,570,251450,174041
5893,1795480,588351,79,0,Stable,Growth,597,359096,229255
5894,846296,253102,95,0,Unstable,Declining,482,169259,83843
5895,1967205,176665,89,0,Unstable,Growth,554,176665,0
5896,513598,194282,85,0,Unstable,Stable,482,102719,91563
5897,809330,259732,84,0,Stable,Stable,564,161866,97866
5898,3391317,1179041,85,0,High Volume,Declining,549,678263,500778
5899,3214018,1460659,96,1,Stable,Declining,484,642803,817856
5900,1449166,583698,82,1,Low Volume,Stable,490,289833,293865
5901,878340,352576,90,1,High Volume,Growth,645,263502,89074
5902,871592,407236,93,0,Low Volume,Declining,518,174318,232918
5903,1470901,728788,93,0,Low Volume,Stable,565,294180,434608
5904,3320463,1034581,96,0,Low Volume,Declining,500,664092,370489
5905,4166540,412474,81,0,Stable,Declining,513,412474,0
5906,1332776,342002,90,0,Low Volume,Growth,610,342002,0
5907,787963,318668,98,0,High Volume,Stable,634,236388,82280
5908,2456566,153477,84,0,Stable,Declining,517,153477,0
5909,1025994,77564,92,1,Low Volume,Growth,558,77564,0
5910,1309817,105075,92,0,Low Volume,Declining,498,105075,0
5911,5724243,2169294,91,0,Stable,Growth,638,1717272,452022
5912,3842725,1058767,82,2,Unstable,Growth,439,768545,290222
5913,2249862,485979,93,0,High Volume,Declining,592,449972,36007
5914,716737,69902,90,0,Stable,Declining,506,69902,0
5915,2348100,891123,91,0,Low Volume,Growth,609,704430,186693
5916,4639540,902200,91,1,Stable,Declining,482,902200,0
5917,1468120,248693,95,0,Stable,Stable,599,248693,0
5918,5843797,2007599,96,1,High Volume,Stable,606,1753139,254460
5919,5577193,1681830,89,0,High Volume,Growth,679,1673157,8673
5920,7504296,1599051,93,0,High Volume,Growth,694,1599051,0
5921,2531176,857232,90,0,Stable,Growth,606,759352,97880
5922,3172128,545764,96,0,Stable,Growth,649,545764,0
5923,6146232,2505657,97,0,Low Volume,Declining,495,1229246,1276411
5924,2836028,434461,89,0,High Volume,Declining,561,434461,0
5925,1327772,161294,96,0,Low Volume,Growth,626,161294,0
5926,1384938,556880,87,0,Stable,Stable,542,276987,279893
5927,2399675,884404,96,1,Stable,Stable,567,479935,404469
5928,706127,93341,93,0,Stable,Declining,544,93341,0
5929,1768059,180891,98,0,Stable,Growth,624,180891,0
5930,4767047,2036862,99,0,Low Volume,Stable,562,953409,1083453
5931,500000,199735,90,1,High Volume,Growth,615,150000,49735
5932,6767117,1334921,92,0,Stable,Growth,613,1334921,0
5933,4866567,1684751,97,0,Unstable,Stable,526,973313,711438
5934,1372560,145316,92,0,Unstable,Declining,485,145316,0
5935,3062410,851875,94,1,High Volume,Stable,583,612482,239393
5936,1987759,116142,96,0,Stable,Growth,623,116142,0
5937,5304109,1199900,94,1,Stable,Declining,508,1060821,139079
5938,4352002,364172,99,1,Stable,Growth,588,364172,0
5939,646898,170662,83,0,High Volume,Stable,618,170662,0
5940,3171800,760460,85,0,Stable,Growth,595,634360,126100
5941,1682006,420457,95,1,Stable,Growth,585,336401,84056
5942,2118600,149148,94,0,Stable,Stable,571,149148,0
5943,1107330,235559,90,1,Low Volume,Growth,563,221466,14093
5944,8028511,3134473,97,1,High Volume,Growth,641,2408553,725920
5945,4556428,984241,94,0,Stable,Stable,595,911285,72956
5946,1097102,407933,97,1,Low Volume,Declining,461,219420,188513
5947,681677,147423,89,0,Unstable,Growth,571,136335,11088
5948,1456376,350197,87,0,Stable,Stable,548,291275,58922
5949,2806931,852609,97,0,Stable,Growth,630,842079,10530
5950,2402847,1148097,88,0,Low Volume,Growth,595,480569,667528
5951,5403223,534850,87,0,High Volume,Growth,671,534850,0
5952,3730063,241750,82,0,Stable,Declining,479,241750,0
5953,4306582,1393527,93,1,High Volume,Growth,621,1291974,101553
5954,2575320,1228669,95,0,Stable,Declining,544,515064,713605
5955,652496,323230,89,1,Low Volume,Growth,537,130499,192731
5956,1695420,454159,89,0,High Volume,Declining,580,339084,115075
5957,4630020,1206753,90,0,Low Volume,Growth,572,926004,280749
5958,1902695,647361,99,0,High Volume,Growth,697,570808,76553
5959,2965251,889681,90,0,High Volume,Stable,640,889575,106
5960,1536475,515241,94,0,Low Volume,Growth,592,307295,207946
5961,869915,385633,96,0,High Volume,Growth,678,260974,124659
5962,1796453,693139,93,1,Stable,Growth,592,359290,333849
5963,2538891,694627,94,0,High Volume,Growth,696,694627,0
5964,1173440,302559,91,2,High Volume,Growth,612,302559,0
5965,1642009,554705,92,0,Stable,Growth,618,492602,62103
5966,935119,238519,92,1,High Volume,Growth,640,238519,0
5967,4854399,1242730,92,0,Stable,Stable,560,970879,271851
5968,1566627,89827,82,1,Unstable,Stable,435,89827,0
5969,6338828,813455,97,0,Low Volume,Growth,628,813455,0
5970,6736144,1817621,95,0,Low Volume,Growth,618,1817621,0
5971,1858282,780839,91,1,Stable,Growth,566,371656,409183
5972,884910,155237,96,0,Low Volume,Declining,512,155237,0
5973,500000,142595,85,0,Low Volume,Stable,539,100000,42595
5974,610706,125337,97,0,Unstable,Declining,482,122141,3196
5975,660619,64187,86,0,High Volume,Declining,560,64187,0
5976,5973095,2874458,89,0,Low Volume,Stable,540,1194619,1679839
5977,2175262,945376,97,0,High Volume,Stable,630,652578,292798
5978,2707899,231042,79,0,High Volume,Stable,569,231042,0
5979,500000,186952,97,1,Stable,Growth,591,100000,86952
5980,760421,156959,81,1,Low Volume,Declining,436,152084,4875
5981,4031559,2006436,95,0,High Volume,Growth,680,1209467,796969
5982,2494052,464092,91,0,High Volume,Declining,578,464092,0
5983,1762486,277472,88,1,Stable,Stable,522,277472,0
5984,3115418,951918,95,1,High Volume,Growth,652,934625,17293
5985,7338450,3124762,96,1,Stable,Growth,615,2201535,923227
5986,1661391,227002,91,2,Unstable,Growth,483,227002,0
5987,2095905,773874,97,0,Low Volume,Growth,607,628771,145103
5988,2313050,179569,87,0,Stable,Growth,607,179569,0
5989,13439218,6229355,86,0,Stable,Declining,495,2687843,3541512
5990,500000,43242,84,0,Unstable,Growth,544,43242,0
5991,3424885,1580256,94,0,Low Volume,Declining,508,684977,895279
5992,1808771,489930,93,0,Stable,Growth,634,489930,0
5993,3120230,785178,92,1,Stable,Stable,534,624046,161132
5994,1171859,571853,97,0,Low Volume,Stable,574,234371,337482
5995,1906592,945046,92,0,Stable,Declining,520,381318,563728
5996,3502994,1200056,97,2,Stable,Growth,544,700598,499458
5997,23922456,2564575,80,0,Low Volume,Growth,540,2564575,0
5998,3784517,1051250,90,1,High Volume,Stable,587,756903,294347
5999,1006055,289868,82,0,Unstable,Growth,555,201211,88657
6000,1412670,397668,87,0,Unstable,Stable,490,282534,115134
6001,1379551,422517,95,1,Stable,Stable,552,275910,146607
6002,500000,29213,93,0,Unstable,Stable,534,29213,0
6003,1522597,563440,91,0,Low Volume,Declining,490,304519,258921
6004,3563534,1320565,79,2,Unstable,Declining,366,712706,607859
6005,715412,72944,86,0,Unstable,Growth,530,72944,0
6006,4587226,1406479,86,0,High Volume,Growth,653,1376167,30312
6007,2929141,895622,93,0,High Volume,Growth,686,878742,16880
6008,1101974,393518,95,0,High Volume,Growth,665,330592,62926
6009,1770507,156564,90,1,High Volume,Stable,574,156564,0
6010,7121703,2363882,94,0,Stable,Declining,523,1424340,939542
6011,3565583,628749,83,1,Stable,Growth,570,628749,0
6012,1996741,555396,82,0,Stable,Growth,600,555396,0
6013,1639420,652482,95,0,Stable,Declining,530,327884,324598
6014,2108078,774804,97,0,High Volume,Growth,706,774804,0
6015,1316634,136280,97,0,High Volume,Growth,709,136280,0
6016,500000,158017,95,0,High Volume,Stable,651,150000,8017
6017,10157697,4937681,93,0,Low Volume,Growth,599,2031539,2906142
6018,2245099,270638,90,0,Unstable,Stable,499,270638,0
6019,2726469,1182765,95,0,High Volume,Growth,676,817940,364825
6020,1893001,693116,98,0,Stable,Growth,637,567900,125216
6021,1101195,438608,93,0,Low Volume,Growth,605,330358,108250
6022,1708729,302242,98,2,Stable,Stable,511,302242,0
6023,551548,99030,98,0,Low Volume,Growth,627,99030,0
6024,12257753,5610481,84,0,Unstable,Stable,482,2451550,3158931
6025,738510,156508,94,0,High Volume,Stable,626,156508,0
6026,868417,68046,89,0,High Volume,Stable,601,68046,0
6027,1394146,446501,93,0,Stable,Declining,545,278829,167672
6028,5556398,589911,87,0,Stable,Stable,579,589911,0
6029,2005908,819350,90,0,High Volume,Stable,633,601772,217578
6030,737552,249872,93,1,Unstable,Declining,433,147510,102362
6031,5408437,2399328,92,0,Low Volume,Stable,558,1081687,1317641
6032,3558325,1434634,90,0,High Volume,Growth,682,1067497,367137
6033,3050292,306405,83,0,Low Volume,Declining,463,306405,0
6034,3515131,778538,96,0,Low Volume,Growth,588,703026,75512
6035,13463455,5365888,84,0,Stable,Growth,619,4039036,1326852
6036,11388059,2708122,89,0,High Volume,Declining,553,2277611,430511
6037,1144671,558101,96,1,Low Volume,Growth,559,228934,329167
6038,7268845,2770035,98,0,High Volume,Stable,627,2180653,589382
6039,2693992,153490,97,0,Stable,Growth,646,153490,0
6040,2955790,1318263,92,0,High Volume,Declining,565,591158,727105
6041,512053,48830,93,1,Unstable,Declining,416,48830,0
6042,1730103,195909,95,1,High Volume,Declining,549,195909,0
6043,1034823,393772,95,0,High Volume,Growth,696,310446,83326
6044,3845626,1689137,90,0,Low Volume,Growth,607,1153687,535450
6045,4670910,1360904,96,0,High Volume,Growth,694,1360904,0
6046,500000,90036,95,0,High Volume,Growth,680,90036,0
6047,1948114,405387,85,0,High Volume,Stable,612,405387,0
6048,4864572,993833,90,0,Stable,Declining,521,972914,20919
6049,1707698,336425,88,0,High Volume,Growth,646,336425,0
6050,3552815,565997,97,0,Stable,Growth,658,565997,0
6051,2625895,850764,94,0,Low Volume,Declining,518,525179,325585
6052,2606003,1186207,91,1,High Volume,Growth,630,781800,404407
6053,1595899,300328,100,2,Low Volume,Growth,533,300328,0
6054,749181,100400,84,1,Low Volume,Stable,492,100400,0
6055,808371,345465,91,0,Low Volume,Stable,550,161674,183791
6056,3497231,1342246,95,0,Stable,Declining,519,699446,642800
6057,2013866,944255,94,0,Stable,Stable,569,402773,541482
6058,1774786,220932,97,0,Low Volume,Stable,558,220932,0
6059,1412523,162317,89,0,High Volume,Growth,669,162317,0
6060,1553233,456096,96,0,Stable,Stable,599,310646,145450
6061,4581465,1495826,81,0,High Volume,Declining,558,916293,579533
6062,1516332,403463,86,0,High Volume,Declining,549,303266,100197
6063,678167,216698,97,0,Low Volume,Stable,564,135633,81065
6064,3594521,471497,84,0,Stable,Stable,534,471497,0
6065,1683017,447390,82,0,Stable,Growth,597,336603,110787
6066,2033190,703772,89,0,High Volume,Growth,648,609957,93815
6067,7174636,1755762,82,0,Stable,Declining,499,1434927,320835
6068,1950413,693862,96,0,High Volume,Stable,625,585123,108739
6069,2498864,632303,95,0,Unstable,Growth,591,499772,132531
6070,772094,154511,94,0,High Volume,Stable,612,154511,0
6071,1663217,310393,99,0,Low Volume,Growth,633,310393,0
6072,3228799,758464,96,0,Unstable,Declining,461,645759,112705
6073,571318,34502,89,0,High Volume,Stable,604,34502,0
6074,2328363,816874,88,0,High Volume,Growth,668,698508,118366
6075,2149257,924820,87,0,Low Volume,Growth,592,429851,494969
6076,2049343,429506,87,0,Low Volume,Stable,526,409868,19638
6077,4545858,321460,85,0,High Volume,Declining,565,321460,0
6078,2590991,1280077,99,0,Low Volume,Stable,551,518198,761879
6079,6468518,1091008,99,1,Low Volume,Growth,569,1091008,0
6080,895492,95799,92,1,Stable,Growth,573,95799,0
6081,2210523,478332,97,1,Unstable,Stable,481,442104,36228
6082,2121372,811108,82,0,Stable,Stable,528,424274,386834
6083,842894,153628,99,0,Stable,Growth,659,153628,0
6084,4261092,1315043,84,0,High Volume,Declining,535,852218,462825
6085,12733395,3017840,94,0,Unstable,Growth,573,2546679,471161
6086,1955967,201452,96,0,High Volume,Stable,651,201452,0
6087,2969835,589896,97,0,High Volume,Declining,609,589896,0
6088,2121459,798075,97,0,Low Volume,Stable,575,424291,373784
6089,1120328,364557,88,0,High Volume,Stable,610,336098,28459
6090,500000,51950,94,1,Stable,Stable,553,51950,0
6091,1127351,139222,96,1,High Volume,Growth,653,139222,0
6092,651110,220290,94,0,High Volume,Declining,576,130222,90068
6093,7750607,3224539,92,0,Stable,Growth,637,2325182,899357
6094,1808326,374800,81,0,Stable,Growth,576,361665,13135
6095,1503437,477927,87,0,Low Volume,Declining,490,300687,177240
6096,4038254,512009,90,0,Stable,Stable,568,512009,0
6097,808228,153660,89,0,Stable,Stable,563,153660,0
6098,1073579,63472,90,0,Stable,Declining,516,63472,0
6099,2093730,828540,89,0,High Volume,Stable,608,628119,200421
6100,4515449,1040605,93,0,High Volume,Growth,673,1040605,0
6101,2961919,1235880,98,0,Low Volume,Growth,622,888575,347305
6102,2418505,891867,75,0,Stable,Declining,465,483701,408166
6103,2110624,892657,89,0,High Volume,Growth,673,633187,259470
6104,2731028,487615,88,0,High Volume,Stable,607,487615,0
6105,2329868,310569,94,0,Low Volume,Stable,546,310569,0
6106,869803,423905,95,1,Unstable,Stable,477,173960,249945
6107,2057214,766924,98,0,Low Volume,Stable,577,411442,355482
6108,839909,357229,89,0,Stable,Growth,601,251972,105257
6109,2115636,118285,91,0,Low Volume,Growth,578,118285,0
6110,1349820,282798,92,0,Stable,Growth,634,282798,0
6111,15119643,5809988,84,1,Stable,Growth,574,3023928,2786060
6112,1920478,163418,88,1,Low Volume,Stable,497,163418,0
6113,644744,196842,96,0,Stable,Stable,596,128948,67894
6114,1780947,432917,95,0,Low Volume,Growth,617,432917,0
6115,3004095,174019,98,0,High Volume,Stable,625,174019,0
6116,7562339,1181154,98,0,High Volume,Declining,607,1181154,0
6117,1237295,220432,94,0,Low Volume,Growth,611,220432,0
6118,559085,56097,94,0,Stable,Growth,629,56097,0
6119,3811257,1273690,82,2,Stable,Stable,467,762251,511439
6120,657054,104524,82,0,Stable,Declining,478,104524,0
6121,1398731,244678,94,1,Unstable,Growth,527,244678,0
6122,1613480,732855,97,0,Low Volume,Growth,600,484044,248811
6123,1875326,487970,89,1,Stable,Growth,571,375065,112905
6124,3441203,779287,92,1,Stable,Growth,577,688240,91047
6125,1147496,431162,96,1,Stable,Stable,539,229499,201663
6126,1592820,731624,85,0,Low Volume,Growth,593,318564,413060
6127,1960252,120097,88,0,Low Volume,Growth,578,120097,0
6128,2234836,562525,92,0,High Volume,Growth,682,562525,0
6129,2144167,696536,89,0,Stable,Stable,566,428833,267703
6130,2810308,543383,90,0,High Volume,Stable,606,543383,0
6131,3894483,1548382,93,0,Stable,Stable,584,778896,769486
6132,2714470,1322394,95,0,High Volume,Stable,641,814341,508053
6133,2850111,1352498,88,0,Low Volume,Stable,527,570022,782476
6134,559177,94888,86,0,Stable,Declining,500,94888,0
6135,2064053,313431,97,0,Low Volume,Growth,604,313431,0
6136,2909832,1399253,87,0,Unstable,Declining,450,581966,817287
6137,3552467,910792,94,0,Unstable,Growth,583,710493,200299
6138,1139522,163788,97,0,High Volume,Declining,609,163788,0
6139,1170298,430844,98,0,Stable,Stable,575,234059,196785
6140,1252584,222946,92,0,Stable,Stable,571,222946,0
6141,3045364,518507,96,1,Low Volume,Stable,515,518507,0
6142,4533953,2020611,87,1,High Volume,Stable,583,906790,1113821
6143,1431212,176205,90,0,Unstable,Stable,522,176205,0
6144,4099477,323764,90,0,Stable,Growth,628,323764,0
6145,2188625,374548,88,0,Stable,Stable,568,374548,0
6146,1795100,580042,90,1,Unstable,Growth,531,359020,221022
6147,1674278,176451,94,1,Low Volume,Growth,551,176451,0
6148,3603042,944781,82,2,Stable,Growth,508,720608,224173
6149,2572689,854909,95,0,Stable,Declining,517,514537,340372
6150,12245393,5289173,84,0,Low Volume,Stable,524,2449078,2840095
6151,1002713,153858,97,0,Low Volume,Declining,516,153858,0
6152,3001076,1253867,89,0,Low Volume,Growth,571,600215,653652
6153,1298395,202170,88,0,High Volume,Growth,660,202170,0
6154,989119,350687,90,0,High Volume,Growth,678,296735,53952
6155,1965596,479218,88,0,High Volume,Growth,675,479218,0
6156,2213049,224860,84,0,High Volume,Stable,621,224860,0
6157,20471390,7603454,95,0,High Volume,Growth,698,6141417,1462037
6158,1711162,253240,93,1,Low Volume,Stable,527,253240,0
6159,802797,103947,89,0,Stable,Declining,527,103947,0
6160,2466741,521087,83,0,Low Volume,Growth,560,493348,27739
6161,500000,171990,84,0,Unstable,Growth,559,100000,71990
6162,1842133,286080,87,0,Stable,Growth,611,286080,0
6163,2008342,266402,89,0,Stable,Stable,568,266402,0
6164,3744057,203973,95,0,High Volume,Growth,694,203973,0
6165,4320570,1133024,90,0,High Volume,Declining,569,864114,268910
6166,1325293,321901,99,0,Stable,Growth,648,321901,0
6167,1757686,272864,84,3,High Volume,Growth,513,272864,0
6168,1074218,79646,91,0,Stable,Stable,559,79646,0
6169,804157,195543,77,0,Stable,Growth,598,160831,34712
6170,2540613,1028167,88,0,Unstable,Growth,566,508122,520045
6171,715782,266183,84,0,Stable,Growth,609,214734,51449
6172,1423029,622373,90,1,High Volume,Growth,637,426908,195465
6173,894357,48575,90,0,Stable,Declining,505,48575,0
6174,3077864,1492421,85,2,Stable,Growth,535,615572,876849
6175,8378204,1706100,96,0,Stable,Growth,653,1706100,0
6176,699926,346939,93,0,Stable,Growth,618,209977,136962
6177,500000,81839,96,0,Low Volume,Growth,606,81839,0
6178,1794237,470433,97,0,Stable,Declining,526,358847,111586
6179,2007816,420171,91,0,High Volume,Growth,686,420171,0
6180,2361783,496192,91,0,Low Volume,Stable,530,472356,23836
6181,1387402,595233,86,0,Stable,Declining,493,277480,317753
6182,1688732,651662,96,0,High Volume,Growth,708,651662,0
6183,2660457,1320832,94,0,Unstable,Stable,526,532091,788741
6184,4557773,1486206,88,0,High Volume,Stable,608,1367331,118875
6185,500000,129233,97,0,Low Volume,Stable,562,100000,29233
6186,1476003,133627,94,0,Low Volume,Declining,485,133627,0
6187,2352636,1172678,94,1,Stable,Stable,530,470527,702151
6188,951333,283677,97,0,High Volume,Growth,692,283677,0
6189,7920269,2892600,95,1,Stable,Growth,592,1584053,1308547
6190,1192631,277924,98,1,Stable,Growth,607,277924,0
6191,1918331,568732,89,0,Unstable,Growth,571,383666,185066
6192,3093512,1466820,86,0,High Volume,Growth,640,928053,538767
6193,1235483,154298,97,0,Stable,Declining,538,154298,0
6194,500000,90784,96,0,Low Volume,Stable,562,90784,0
6195,1407149,166644,92,0,Stable,Declining,525,166644,0
6196,4517876,1836504,92,0,Stable,Stable,594,903575,932929
6197,1514330,117997,99,1,Low Volume,Declining,481,117997,0
6198,1007369,87373,80,3,Stable,Growth,462,87373,0
6199,4157971,766407,85,0,Low Volume,Stable,518,766407,0
6200,1521763,428201,88,0,High Volume,Growth,673,428201,0
6201,1318323,306937,91,1,Stable,Stable,552,263664,43273
6202,2234582,156795,91,0,High Volume,Declining,580,156795,0
6203,3673297,1766383,95,0,Low Volume,Growth,614,1101989,664394
6204,13327909,6381287,95,0,Low Volume,Growth,617,3998372,2382915
6205,3843096,675272,98,0,Stable,Growth,641,675272,0
6206,5014639,1901484,99,0,Stable,Declining,554,1002927,898557
6207,1322755,410529,92,0,Stable,Stable,592,264551,145978
6208,872664,136890,99,0,High Volume,Stable,635,136890,0
6209,2084136,350087,97,1,Stable,Stable,544,350087,0
6210,2160253,585469,96,0,Stable,Growth,622,585469,0
6211,836674,199678,91,0,Stable,Declining,537,167334,32344
6212,1723322,312013,95,0,Low Volume,Stable,541,312013,0
6213,2729023,1128124,82,0,Stable,Stable,526,545804,582320
6214,2645352,705405,91,1,Stable,Declining,497,529070,176335
6215,2968093,1023047,93,1,Unstable,Growth,546,593618,429429
6216,2502427,338261,96,0,High Volume,Growth,669,338261,0
6217,1321652,383383,92,1,Stable,Stable,519,264330,119053
6218,1314385,253794,93,0,High Volume,Stable,618,253794,0
6219,759822,217982,96,0,Stable,Growth,652,217982,0
6220,8267312,3318264,81,0,Low Volume,Growth,576,1653462,1664802
6221,2004210,793689,93,1,Low Volume,Growth,577,400842,392847
6222,1656334,346835,88,0,Stable,Stable,575,331266,15569
6223,943137,341816,91,1,High Volume,Growth,633,282941,58875
6224,20759745,9831410,88,1,High Volume,Declining,524,4151949,5679461
6225,840152,278553,93,0,Low Volume,Stable,551,168030,110523
6226,1406932,164308,90,1,Low Volume,Declining,465,164308,0
6227,2765327,984094,83,0,High Volume,Growth,643,829598,154496
6228,3204832,311532,92,0,High Volume,Declining,556,311532,0
6229,4266676,1887789,94,0,Low Volume,Declining,510,853335,1034454
6230,8419717,2378547,93,0,Unstable,Growth,578,1683943,694604
6231,2972536,663807,90,0,Stable,Growth,618,663807,0
6232,851858,64446,93,0,High Volume,Growth,691,64446,0
6233,1614352,357341,93,1,Stable,Growth,592,322870,34471
6234,2536424,1157733,84,0,Low Volume,Stable,507,507284,650449
6235,10371589,616512,83,0,Stable,Growth,588,616512,0
6236,648071,170826,85,0,High Volume,Stable,602,170826,0
6237,5189050,2433774,90,1,Stable,Growth,566,1037810,1395964
6238,2289700,521315,94,0,Low Volume,Growth,591,457940,63375
6239,3875807,940577,85,0,Stable,Stable,562,775161,165416
6240,1827399,567137,94,0,Stable,Growth,650,548219,18918
6241,1010599,261060,89,0,Unstable,Stable,520,202119,58941
6242,3615346,455066,99,1,Unstable,Growth,560,455066,0
6243,3346899,195292,82,1,Low Volume,Stable,482,195292,0
6244,4315163,1399905,95,0,High Volume,Stable,617,1294548,105357
6245,1961767,910972,90,0,High Volume,Stable,606,588530,322442
6246,1227073,120086,91,0,Stable,Growth,617,120086,0
6247,569760,82575,93,1,High Volume,Growth,657,82575,0
6248,3818998,827207,96,0,High Volume,Declining,602,827207,0
6249,2783199,1152061,98,0,High Volume,Growth,674,834959,317102
6250,915636,156727,89,1,Stable,Declining,470,156727,0
6251,1288696,575950,93,0,Stable,Stable,599,257739,318211
6252,1364902,102001,77,1,Stable,Stable,496,102001,0
6253,605380,286605,97,1,High Volume,Declining,552,121076,165529
6254,1030809,311651,92,1,Stable,Stable,535,206161,105490
6255,800455,277318,89,1,High Volume,Growth,642,240136,37182
6256,1425477,307134,97,0,High Volume,Growth,706,307134,0
6257,1098045,441301,88,0,Stable,Stable,578,219609,221692
6258,539499,67413,96,0,Stable,Stable,583,67413,0
6259,9999765,720086,93,0,Low Volume,Growth,584,720086,0
6260,5400665,1231258,81,0,Stable,Growth,594,1080133,151125
6261,1063190,461598,93,0,Stable,Stable,565,212638,248960
6262,2465579,960878,93,0,Stable,Stable,589,493115,467763
6263,2768932,782833,98,1,High Volume,Declining,550,553786,229047
6264,5141568,1580837,90,1,Stable,Declining,475,1028313,552524
6265,1030048,111711,97,0,Stable,Declining,560,111711,0
6266,4750144,2034518,88,0,Low Volume,Stable,527,950028,1084490
6267,1279111,516930,96,0,High Volume,Stable,626,383733,133197
6268,680995,235224,83,0,High Volume,Growth,644,204298,30926
6269,3538839,919341,98,0,High Volume,Declining,581,707767,211574
6270,5568336,2695112,94,0,Stable,Declining,538,1113667,1581445
6271,15718158,7003451,91,0,Stable,Stable,566,3143631,3859820
6272,759351,258175,98,0,High Volume,Stable,625,227805,30370
6273,3468163,753668,95,0,Stable,Declining,554,693632,60036
6274,1428534,468716,93,1,Low Volume,Declining,462,285706,183010
6275,3710536,1146364,84,0,High Volume,Declining,539,742107,404257
6276,611462,139052,86,0,Stable,Declining,494,122292,16760
6277,722003,135739,88,0,Low Volume,Stable,528,135739,0
6278,1065868,248512,92,0,Stable,Growth,628,248512,0
6279,2112053,651062,95,0,Stable,Stable,593,422410,228652
6280,1187232,288095,91,0,Low Volume,Stable,549,237446,50649
6281,3359301,566407,97,0,Low Volume,Declining,501,566407,0
6282,4508683,1769358,93,1,Stable,Growth,577,901736,867622
6283,3203204,926240,87,1,Stable,Growth,584,640640,285600
6284,7239264,582426,84,0,High Volume,Stable,614,582426,0
6285,2765304,596593,86,1,High Volume,Declining,526,553060,43533
6286,748991,335706,89,1,Stable,Growth,570,149798,185908
6287,5901406,2300701,94,0,Stable,Growth,642,1770421,530280
6288,1221848,238824,90,1,Low Volume,Stable,517,238824,0
6289,4107540,1939508,95,0,Low Volume,Stable,573,821508,1118000
6290,6982987,589862,93,0,High Volume,Declining,585,589862,0
6291,2857194,1378755,85,0,Stable,Declining,502,571438,807317
6292,599034,96185,94,1,Low Volume,Growth,552,96185,0
6293,951153,51450,93,0,High Volume,Growth,693,51450,0
6294,5712661,1400822,88,0,Stable,Stable,561,1142532,258290
6295,1731852,366350,97,0,High Volume,Stable,627,366350,0
6296,2113084,618267,91,0,High Volume,Growth,671,618267,0
6297,3638418,1486468,94,0,Stable,Declining,539,727683,758785
6298,3460966,1485079,98,0,Stable,Declining,530,692193,792886
6299,2478192,571356,99,0,High Volume,Stable,628,571356,0
6300,1677920,408457,81,0,High Volume,Growth,654,408457,0
6301,1543966,180150,92,0,High Volume,Growth,677,180150,0
6302,3938534,281197,91,0,Low Volume,Growth,602,281197,0
6303,3087449,1045246,85,0,High Volume,Growth,648,926234,119012
6304,1613893,127493,94,0,Stable,Declining,514,127493,0
6305,4712315,1791733,96,0,High Volume,Growth,676,1413694,378039
6306,1788294,523238,85,0,Stable,Growth,599,357658,165580
6307,1003165,139803,91,0,Stable,Growth,608,139803,0
6308,1080380,316319,85,0,Unstable,Growth,549,216076,100243
6309,906193,119934,93,0,Low Volume,Growth,618,119934,0
6310,1594502,394530,93,0,Unstable,Declining,452,318900,75630
6311,5319976,2180138,98,1,Stable,Declining,504,1063995,1116143
6312,1041241,268498,97,0,Low Volume,Stable,543,208248,60250
6313,2305437,269539,95,0,Low Volume,Growth,587,269539,0
6314,1172500,440535,94,0,High Volume,Stable,650,351750,88785
6315,1610013,215815,94,0,Unstable,Declining,481,215815,0
6316,592418,226510,95,0,High Volume,Declining,567,118483,108027
6317,1662062,441624,96,1,Low Volume,Stable,523,332412,109212
6318,1698126,431636,97,0,Low Volume,Growth,600,431636,0
6319,3054817,1323181,85,0,High Volume,Declining,539,610963,712218
6320,2370531,874422,85,1,Unstable,Stable,448,474106,400316
6321,760162,49266,97,0,Unstable,Growth,570,49266,0
6322,4720185,865108,94,0,Stable,Growth,620,865108,0
6323,2346047,1036752,91,0,High Volume,Growth,690,703814,332938
6324,2323801,135354,89,0,Stable,Stable,549,135354,0
6325,1968248,581350,83,0,Stable,Growth,589,393649,187701
6326,1310336,494680,91,0,Unstable,Growth,545,262067,232613
6327,2360164,778465,85,0,Stable,Stable,572,472032,306433
6328,2900724,1137779,95,0,Stable,Declining,552,580144,557635
6329,500000,188281,99,0,Stable,Growth,665,150000,38281
6330,1288503,465683,94,0,High Volume,Stable,652,386550,79133
6331,1616934,678616,93,1,Stable,Growth,582,323386,355230
6332,2433732,828834,97,0,Stable,Declining,523,486746,342088
6333,5150729,1190273,88,0,Stable,Stable,549,1030145,160128
6334,1069399,280567,97,0,Low Volume,Growth,604,280567,0
6335,1331252,495926,93,0,High Volume,Stable,624,399375,96551
6336,1315823,584670,95,0,Stable,Stable,589,263164,321506
6337,1044217,180126,96,0,High Volume,Stable,644,180126,0
6338,1501914,306292,95,0,High Volume,Declining,586,300382,5910
6339,3673450,1722234,88,0,Stable,Declining,504,734690,987544
6340,853356,264822,92,1,High Volume,Growth,652,256006,8816
6341,2791952,364441,97,0,High Volume,Stable,639,364441,0
6342,508123,177164,92,1,Low Volume,Stable,504,101624,75540
6343,1265439,627459,97,1,Stable,Stable,546,253087,374372
6344,1523329,640642,91,0,High Volume,Declining,582,304665,335977
6345,7571394,2919405,86,0,Unstable,Stable,485,1514278,1405127
6346,1591453,228566,94,0,Unstable,Growth,581,228566,0
6347,500000,222131,90,0,High Volume,Stable,607,150000,72131
6348,500000,143302,85,0,Unstable,Growth,561,100000,43302
6349,2037479,917233,96,2,Stable,Growth,566,407495,509738
6350,3239782,642846,93,0,Unstable,Stable,512,642846,0
6351,2677421,208633,96,0,Unstable,Growth,593,208633,0
6352,2267200,598970,93,1,Stable,Stable,554,453440,145530
6353,5024355,861310,94,0,High Volume,Declining,600,861310,0
6354,1287647,478816,93,0,Unstable,Declining,460,257529,221287
6355,4056895,1950141,96,0,Stable,Growth,630,1217068,733073
6356,537341,193947,93,0,Stable,Growth,620,161202,32745
6357,961300,431739,96,0,Stable,Stable,581,192260,239479
6358,500000,126930,97,0,Stable,Stable,580,100000,26930
6359,1591399,632165,82,1,Unstable,Growth,483,318279,313886
6360,1910721,820405,92,2,Low Volume,Growth,519,382144,438261
6361,2172266,803508,92,0,High Volume,Stable,642,651679,151829
6362,2083389,580223,89,0,High Volume,Growth,671,580223,0
6363,944072,313092,89,0,High Volume,Stable,604,283221,29871
6364,1702839,621925,90,0,Stable,Stable,562,340567,281358
6365,598417,98073,83,0,Low Volume,Declining,451,98073,0
6366,5900710,2444727,98,0,Stable,Declining,532,1180142,1264585
6367,1555176,742824,94,0,Stable,Growth,651,466552,276272
6368,1340953,347786,91,0,High Volume,Growth,662,347786,0
6369,7068453,2583380,92,0,Stable,Growth,624,2120535,462845
6370,733955,280122,91,0,High Volume,Growth,680,220186,59936
6371,805751,280411,92,0,High Volume,Stable,623,241725,38686
6372,824905,244338,98,0,Stable,Growth,641,244338,0
6373,1877972,838968,91,0,High Volume,Growth,660,563391,275577
6374,2800491,705771,96,0,Unstable,Growth,598,560098,145673
6375,3583105,277677,93,0,Unstable,Growth,588,277677,0
6376,15519320,6674089,98,0,Low Volume,Growth,601,4655796,2018293
6377,500000,176646,94,0,Stable,Growth,647,150000,26646
6378,3226758,1394496,89,0,Low Volume,Stable,548,645351,749145
6379,1269706,142647,92,1,Unstable,Declining,426,142647,0
6380,1240305,79180,86,0,High Volume,Growth,640,79180,0
6381,1207644,568159,95,0,Stable,Declining,538,241528,326631
6382,958365,111628,84,1,Low Volume,Growth,527,111628,0
6383,7630164,3161509,92,0,Stable,Growth,624,2289049,872460
6384,3889682,1635395,89,0,Low Volume,Declining,488,777936,857459
6385,2019896,745175,94,0,Stable,Declining,533,403979,341196
6386,5843337,637321,92,0,Stable,Growth,618,637321,0
6387,591240,207129,86,1,Stable,Stable,509,118248,88881
6388,683810,307775,88,0,High Volume,Stable,621,205143,102632
6389,500000,120745,87,1,High Volume,Stable,558,100000,20745
6390,1133101,267505,87,1,High Volume,Stable,559,226620,40885
6391,2256575,562533,84,0,High Volume,Growth,651,562533,0
6392,2152815,187343,99,0,High Volume,Growth,691,187343,0
6393,2234378,1008624,97,0,Low Volume,Growth,594,446875,561749
6394,641237,282870,93,0,Stable,Growth,632,192371,90499
6395,3769767,1881337,88,0,Stable,Growth,599,753953,1127384
6396,2401735,752541,94,1,High Volume,Growth,644,720520,32021
6397,3564176,1383029,93,0,High Volume,Growth,698,1069252,313777
6398,500000,70601,94,1,High Volume,Growth,636,70601,0
6399,2543859,891338,91,0,Unstable,Stable,522,508771,382567
6400,766652,262486,83,1,High Volume,Growth,608,229995,32491
6401,1442865,657288,89,0,High Volume,Declining,573,288573,368715
6402,3040377,1288684,93,0,Stable,Stable,585,608075,680609
6403,2132648,1007271,95,1,Stable,Declining,508,426529,580742
6404,1003263,442414,94,0,Low Volume,Growth,614,300978,141436
6405,1992735,878621,95,0,Low Volume,Growth,594,398547,480074
6406,582318,45814,95,0,Low Volume,Declining,493,45814,0
6407,4976383,2143243,93,0,Low Volume,Growth,586,995276,1147967
6408,1682469,544052,95,0,High Volume,Growth,678,504740,39312
6409,4851701,1073196,85,1,High Volume,Growth,595,970340,102856
6410,1301170,98149,97,0,High Volume,Stable,630,98149,0
6411,1304251,462948,95,0,Low Volume,Growth,588,260850,202098
6412,1075881,212692,91,0,Stable,Growth,620,212692,0
6413,3996538,1041095,82,0,Unstable,Stable,495,799307,241788
6414,1124057,401039,88,0,Stable,Declining,534,224811,176228
6415,3320667,1528498,91,1,High Volume,Stable,588,664133,864365
6416,1460133,615368,88,0,High Volume,Growth,657,438039,177329
6417,500000,126384,90,0,Stable,Growth,628,126384,0
6418,1256385,282061,87,0,High Volume,Stable,599,251277,30784
6419,771980,121896,92,0,Stable,Growth,642,121896,0
6420,2037272,443294,98,0,High Volume,Stable,645,443294,0
6421,765033,76481,88,1,Low Volume,Stable,497,76481,0
6422,4158979,2025412,88,0,Stable,Growth,628,1247693,777719
6423,1843431,568261,83,1,Low Volume,Stable,494,368686,199575
6424,1720152,184938,87,0,Unstable,Declining,461,184938,0
6425,3350814,699525,90,0,Stable,Stable,564,670162,29363
6426,4287119,1269706,96,0,Low Volume,Declining,494,857423,412283
6427,1951133,565435,96,0,High Volume,Stable,652,565435,0
6428,1069862,70586,90,0,Unstable,Stable,516,70586,0
6429,500000,238939,86,1,High Volume,Declining,531,100000,138939
6430,1145281,199186,93,2,Stable,Growth,553,199186,0
6431,1210120,69319,95,0,Unstable,Growth,560,69319,0
6432,2160059,182309,91,0,High Volume,Growth,656,182309,0
6433,1504367,467990,95,1,High Volume,Declining,526,300873,167117
6434,3437814,385047,88,0,High Volume,Stable,632,385047,0
6435,1214221,83509,92,0,High Volume,Stable,619,83509,0
6436,1894314,418325,88,1,Stable,Stable,507,378862,39463
6437,5112453,1688349,90,1,High Volume,Stable,594,1022490,665859
6438,2606347,261489,86,0,High Volume,Stable,600,261489,0
6439,1889778,360943,97,1,Low Volume,Growth,579,360943,0
6440,1224991,291538,95,0,High Volume,Declining,598,244998,46540
6441,1194711,145464,94,0,High Volume,Growth,687,145464,0
6442,1004007,278846,97,1,High Volume,Stable,619,278846,0
6443,1286189,113630,82,1,High Volume,Stable,561,113630,0
6444,3629236,257434,85,0,High Volume,Growth,638,257434,0
6445,1660268,471393,92,0,Low Volume,Growth,589,332053,139340
6446,673458,108800,91,0,High Volume,Stable,613,108800,0
6447,8158211,758046,91,0,High Volume,Growth,655,758046,0
6448,2561163,616627,91,0,Stable,Stable,575,512232,104395
6449,643351,297108,99,2,High Volume,Growth,604,193005,104103
6450,1392374,523375,93,0,Stable,Growth,634,417712,105663
6451,2166685,903566,94,1,High Volume,Declining,535,433337,470229
6452,7753645,3429912,83,0,Stable,Growth,583,1550729,1879183
6453,817094,398482,94,0,Stable,Declining,533,163418,235064
6454,4328937,1703268,92,0,Stable,Growth,619,1298681,404587
6455,6074372,1966782,93,0,Stable,Growth,620,1822311,144471
6456,1199094,257136,91,0,Stable,Stable,555,239818,17318
6457,1588005,209203,87,0,Unstable,Stable,510,209203,0
6458,865405,310678,86,0,Low Volume,Declining,477,173081,137597
6459,1684924,838633,90,0,Unstable,Growth,542,336984,501649
6460,1925561,501245,88,0,High Volume,Stable,626,501245,0
6461,3360902,1262542,93,0,Unstable,Stable,511,672180,590362
6462,4742841,1293807,97,0,Stable,Stable,588,948568,345239
6463,1089820,266319,95,0,High Volume,Growth,675,266319,0
6464,500000,117319,93,0,Stable,Stable,584,100000,17319
6465,1949345,540127,89,0,Low Volume,Stable,523,389869,150258
6466,2507583,539389,89,1,Unstable,Declining,422,501516,37873
6467,2420620,936654,93,3,Stable,Declining,391,484124,452530
6468,1526765,677002,92,1,High Volume,Growth,616,458029,218973
6469,2190853,979965,88,0,High Volume,Stable,610,657255,322710
6470,6664836,1016150,89,0,Stable,Declining,508,1016150,0
6471,2690903,1219407,91,1,Stable,Declining,500,538180,681227
6472,1470783,299596,95,1,High Volume,Growth,633,299596,0
6473,1328873,251407,89,0,Low Volume,Declining,483,251407,0
6474,1730841,652597,88,1,High Volume,Growth,642,519252,133345
6475,7343984,1374157,97,1,Stable,Stable,548,1374157,0
6476,1712319,126429,91,1,Stable,Stable,535,126429,0
6477,1951609,425701,83,0,Unstable,Declining,445,390321,35380
6478,1348022,505049,94,0,Stable,Declining,513,269604,235445
6479,4776347,941567,89,0,Stable,Declining,523,941567,0
6480,9510146,3169747,97,1,Stable,Stable,571,1902029,1267718
6481,2843341,986792,95,0,Stable,Growth,629,853002,133790
6482,2118499,805414,97,2,High Volume,Growth,627,635549,169865
6483,2041971,926460,97,0,Stable,Growth,625,612591,313869
6484,500000,122327,93,0,Low Volume,Growth,609,122327,0
6485,3598835,449474,85,0,Unstable,Declining,465,449474,0
6486,2207416,427172,89,1,Stable,Growth,593,427172,0
6487,2793131,682851,96,0,Stable,Declining,552,558626,124225
6488,1122232,416630,93,0,Stable,Stable,577,224446,192184
6489,1457793,81498,94,0,Low Volume,Declining,509,81498,0
6490,1427136,274158,92,1,High Volume,Declining,517,274158,0
6491,4489709,1800055,94,0,Stable,Stable,597,897941,902114
6492,1464453,515320,85,0,High Volume,Growth,654,439335,75985
6493,10492049,3979456,98,1,High Volume,Growth,636,3147614,831842
6494,2798768,1162370,87,0,Low Volume,Growth,568,559753,602617
6495,714583,287588,96,0,High Volume,Growth,707,285833,1755
6496,1788992,638639,98,0,Stable,Stable,603,536697,101942
6497,1177212,291769,94,0,Low Volume,Stable,543,235442,56327
6498,500000,246310,91,0,Low Volume,Growth,611,150000,96310
6499,7128253,2181837,95,0,Stable,Declining,531,1425650,756187
6500,3479900,491522,98,0,Stable,Declining,525,491522,0
6501,3037562,552125,95,1,Stable,Growth,611,552125,0
6502,2263274,819539,97,0,High Volume,Growth,693,678982,140557
6503,656308,305927,96,0,Low Volume,Growth,626,196892,109035
6504,1346617,175631,87,2,High Volume,Stable,537,175631,0
6505,3888075,338480,82,0,Stable,Declining,494,338480,0
6506,855143,381983,92,0,High Volume,Stable,607,256542,125441
6507,500000,230938,93,0,Low Volume,Stable,560,100000,130938
6508,1653352,288296,94,0,Low Volume,Growth,614,288296,0
6509,1770184,389049,89,0,Stable,Stable,586,354036,35013
6510,2209884,767017,82,0,High Volume,Growth,648,662965,104052
6511,3551267,704815,94,0,Unstable,Stable,515,704815,0
6512,3302151,1468537,93,0,Stable,Growth,624,990645,477892
6513,2438798,240003,93,2,High Volume,Growth,612,240003,0
6514,5159886,346187,86,0,High Volume,Stable,627,346187,0
6515,588201,84594,98,0,High Volume,Growth,693,84594,0
6516,2968791,530640,93,1,High Volume,Stable,604,530640,0
6517,3273043,329978,93,1,High Volume,Stable,597,329978,0
6518,735533,58520,85,1,Unstable,Declining,393,58520,0
6519,595826,232386,91,0,High Volume,Declining,561,119165,113221
6520,1091700,135288,80,1,Stable,Stable,504,135288,0
6521,1167957,538738,88,0,Low Volume,Growth,580,233591,305147
6522,3622720,781058,95,0,Stable,Growth,621,781058,0
6523,1212711,426599,92,1,Unstable,Stable,471,242542,184057
6524,999411,151342,84,1,Unstable,Growth,518,151342,0
6525,1215533,192231,91,1,Stable,Growth,580,192231,0
6526,4852021,1497427,94,1,Low Volume,Growth,580,970404,527023
6527,2003557,605654,79,1,Stable,Growth,540,400711,204943
6528,1717876,680155,95,0,Stable,Declining,532,343575,336580
6529,1815725,709978,91,1,High Volume,Growth,620,544717,165261
6530,5574138,1961035,91,0,Stable,Growth,627,1672241,288794
6531,1088883,274517,89,0,High Volume,Growth,666,274517,0
6532,5679687,2560336,94,0,High Volume,Growth,662,1703906,856430
6533,2346410,774691,91,0,High Volume,Growth,676,703923,70768
6534,1743952,864284,93,0,Low Volume,Growth,591,348790,515494
6535,14661278,6138918,92,0,High Volume,Stable,616,4398383,1740535
6536,852125,59597,98,0,Low Volume,Stable,581,59597,0
6537,1494125,290260,89,0,Unstable,Stable,519,290260,0
6538,739741,227355,92,0,Stable,Growth,635,221922,5433
6539,4248046,1591578,92,0,Low Volume,Growth,592,849609,741969
6540,7658687,2279619,93,0,Stable,Growth,613,2279619,0
6541,7541550,3044966,98,0,Low Volume,Stable,582,1508310,1536656
6542,5278534,935330,90,0,Stable,Growth,621,935330,0
6543,1692815,224739,84,0,Unstable,Growth,536,224739,0
6544,1480377,109937,93,0,Unstable,Growth,558,109937,0
6545,520770,160393,88,1,Stable,Stable,541,104154,56239
6546,10106596,3637059,90,0,High Volume,Stable,600,3031978,605081
6547,2885424,567757,86,0,Stable,Stable,552,567757,0
6548,1337663,436229,87,0,Stable,Stable,569,267532,168697
6549,5736992,421501,87,0,Unstable,Growth,551,421501,0
6550,910536,86211,95,0,Low Volume,Stable,549,86211,0
6551,2745016,1004098,84,0,Low Volume,Growth,586,549003,455095
6552,1727001,372396,96,0,Low Volume,Declining,492,345400,26996
6553,3304982,1163685,93,0,Stable,Growth,627,991494,172191
6554,1884440,799520,95,0,Unstable,Declining,468,376888,422632
6555,621106,269361,91,0,Stable,Growth,617,186331,83030
6556,2106337,268506,93,0,Stable,Stable,577,268506,0
6557,4588627,1233554,90,0,High Volume,Declining,576,917725,315829
6558,1936953,736559,87,1,Stable,Stable,516,387390,349169
6559,3686146,1468160,81,0,High Volume,Growth,641,1105843,362317
6560,859045,346285,92,0,Stable,Growth,628,257713,88572
6561,1941539,296425,97,0,Stable,Stable,606,296425,0
6562,1203075,164389,93,1,Stable,Stable,536,164389,0
6563,3604107,1137116,96,2,Unstable,Growth,501,720821,416295
6564,2033346,779765,94,0,Stable,Growth,618,610003,169762
6565,3443707,666746,91,0,High Volume,Growth,677,666746,0
6566,4733466,459702,99,2,Stable,Declining,453,459702,0
6567,3447965,1284491,98,0,Stable,Declining,528,689593,594898
6568,2466954,456051,83,0,Stable,Declining,519,456051,0
6569,892186,111401,94,1,High Volume,Stable,595,111401,0
6570,1978345,230429,95,0,High Volume,Declining,584,230429,0
6571,1294361,248141,87,0,High Volume,Growth,661,248141,0
6572,1505670,476853,94,2,Unstable,Growth,491,301134,175719
6573,1469412,310459,97,0,Stable,Growth,630,310459,0
6574,905334,53684,89,0,Stable,Growth,619,53684,0
6575,500000,46804,95,0,Low Volume,Growth,617,46804,0
6576,1161805,209969,82,0,High Volume,Growth,640,209969,0
6577,2314498,802823,87,0,Stable,Growth,624,694349,108474
6578,674319,63610,85,0,Stable,Growth,599,63610,0
6579,2007791,606946,97,1,High Volume,Declining,535,401558,205388
6580,9067569,942561,96,0,High Volume,Growth,676,942561,0
6581,4494861,652775,93,1,Stable,Stable,545,652775,0
6582,7384053,941355,83,1,Low Volume,Declining,436,941355,0
6583,2711201,217582,96,0,Low Volume,Stable,546,217582,0
6584,5045503,1776514,98,2,Low Volume,Stable,499,1009100,767414
6585,1111063,287245,96,2,Low Volume,Stable,466,222212,65033
6586,1184141,502045,94,1,Stable,Growth,602,355242,146803
6587,500000,47250,99,0,Stable,Stable,590,47250,0
6588,5121287,589613,99,0,Unstable,Stable,531,589613,0
6589,6798817,1277538,96,0,Low Volume,Growth,628,1277538,0
6590,1273728,502664,94,0,Stable,Growth,613,382118,120546
6591,1618222,303565,92,0,Stable,Stable,587,303565,0
6592,1084804,253615,98,1,Stable,Declining,510,216960,36655
6593,2692883,500127,85,0,Stable,Stable,541,500127,0
6594,4876538,419874,91,0,Stable,Growth,616,419874,0
6595,500000,236373,93,0,High Volume,Declining,587,100000,136373
6596,2751208,816676,91,0,Stable,Growth,642,816676,0
6597,1589075,642820,91,0,Low Volume,Growth,592,317815,325005
6598,2171037,751745,93,0,Stable,Stable,597,434207,317538
6599,2862469,805540,97,2,High Volume,Growth,595,572493,233047
6600,1705618,154111,92,0,Low Volume,Growth,593,154111,0
6601,1825073,619120,87,1,Low Volume,Declining,428,365014,254106
6602,1670945,200374,90,1,Low Volume,Growth,536,200374,0
6603,4309157,1018997,93,1,Stable,Stable,542,861831,157166
6604,2771801,923289,86,0,Low Volume,Growth,579,554360,368929
6605,2365422,950907,90,0,Low Volume,Growth,589,473084,477823
6606,717292,256984,91,0,Low Volume,Growth,599,143458,113526
6607,1464664,515840,90,0,Stable,Growth,619,439399,76441
6608,4069112,476367,97,0,Stable,Stable,576,476367,0
6609,2043465,420459,96,0,High Volume,Growth,675,420459,0
6610,3360583,232924,92,0,Low Volume,Growth,590,232924,0
6611,8147400,3045210,98,0,High Volume,Stable,645,2444220,600990
6612,4551124,2178458,84,0,Low Volume,Growth,586,910224,1268234
6613,2136173,360692,85,1,Stable,Growth,557,360692,0
6614,1317450,117864,92,1,Low Volume,Declining,463,117864,0
6615,500000,132003,90,1,Stable,Growth,579,100000,32003
6616,1732874,754691,96,0,Stable,Stable,596,346574,408117
6617,1527572,455810,94,1,Stable,Growth,576,305514,150296
6618,2709550,192513,86,0,High Volume,Declining,540,192513,0
6619,1753064,856236,91,0,High Volume,Stable,629,525919,330317
6620,1534464,648913,95,1,Stable,Growth,579,306892,342021
6621,500000,54609,95,0,Unstable,Growth,574,54609,0
6622,934742,434476,94,0,Stable,Stable,584,186948,247528
6623,2903190,733955,93,0,Low Volume,Declining,510,580638,153317
6624,7824153,1700612,87,0,Unstable,Growth,542,1564830,135782
6625,1833945,472193,82,1,High Volume,Growth,617,472193,0
6626,2577290,1096785,96,0,Stable,Growth,633,773187,323598
6627,4248101,1473096,96,0,Stable,Stable,594,849620,623476
6628,1036422,79454,94,0,High Volume,Growth,662,79454,0
6629,2658975,1278759,87,0,High Volume,Growth,652,797692,481067
6630,1096472,127742,94,0,High Volume,Stable,624,127742,0
6631,3960416,1526762,91,0,Low Volume,Growth,580,792083,734679
6632,2238066,752575,95,0,Stable,Growth,653,671419,81156
6633,2517461,338316,88,0,High Volume,Stable,622,338316,0
6634,1060150,134458,90,0,Low Volume,Growth,608,134458,0
6635,3490746,1541679,89,1,High Volume,Growth,622,1047223,494456
6636,10509292,2510278,93,0,Low Volume,Stable,533,2101858,408420
6637,885290,305035,93,0,Unstable,Declining,481,177058,127977
6638,1510865,418256,88,0,Stable,Growth,613,418256,0
6639,2386375,900401,95,1,Stable,Stable,562,477275,423126
6640,3719594,988144,90,0,High Volume,Declining,585,743918,244226
6641,1267254,227245,91,1,Stable,Growth,594,227245,0
6642,500000,106761,84,0,Stable,Stable,533,100000,6761
6643,5881672,2567850,86,2,Low Volume,Growth,489,1176334,1391516
6644,3643316,949505,95,0,Low Volume,Growth,623,949505,0
6645,500000,73026,87,0,High Volume,Growth,652,73026,0
6646,1219492,573859,90,0,Stable,Stable,583,243898,329961
6647,6952042,2839702,81,0,Low Volume,Stable,533,1390408,1449294
6648,6313730,473844,95,0,Stable,Growth,648,473844,0
6649,4201331,2098667,92,0,Stable,Growth,617,1260399,838268
6650,1722195,624669,97,0,Low Volume,Growth,607,516658,108011
6651,2118862,258755,84,0,Unstable,Growth,527,258755,0
6652,1785590,279847,87,0,High Volume,Stable,620,279847,0
6653,4889457,1768030,84,0,High Volume,Stable,603,1466837,301193
6654,983946,394457,97,0,Low Volume,Declining,527,196789,197668
6655,1040654,163972,85,0,High Volume,Growth,657,163972,0
6656,4449132,736936,95,0,Low Volume,Growth,600,736936,0
6657,1913627,360153,93,0,Stable,Growth,634,360153,0
6658,5973084,1906060,90,1,High Volume,Growth,649,1791925,114135
6659,1158678,147520,91,0,Stable,Stable,583,147520,0
6660,1897746,183910,95,0,High Volume,Growth,666,183910,0
6661,947962,336990,79,1,High Volume,Growth,579,189592,147398
6662,1994472,798974,95,0,Stable,Growth,638,598341,200633
6663,607533,167326,87,0,High Volume,Growth,667,167326,0
6664,1342298,286882,95,0,High Volume,Growth,701,286882,0
6665,628441,153603,97,0,High Volume,Declining,606,153603,0
6666,3454328,776476,92,0,Stable,Stable,572,690865,85611
6667,3517537,1695429,95,0,Unstable,Growth,594,703507,991922
6668,500000,197820,91,1,High Volume,Growth,642,150000,47820
6669,5763806,827909,88,0,Stable,Stable,547,827909,0
6670,14620455,3258682,88,0,Stable,Growth,634,3258682,0
6671,2057095,606443,89,1,High Volume,Growth,624,606443,0
6672,1187201,386842,94,2,High Volume,Growth,621,356160,30682
6673,18990786,4950570,92,0,High Volume,Growth,682,4950570,0
6674,690261,286153,95,0,Stable,Declining,545,138052,148101
6675,2014910,796741,95,0,Unstable,Growth,592,402982,393759
6676,2289165,634834,87,1,Stable,Stable,540,457833,177001
6677,5815970,2527000,89,0,High Volume,Growth,658,1744791,782209
6678,2643967,1025834,95,0,High Volume,Growth,695,793190,232644
6679,1330537,532696,96,0,Unstable,Stable,535,266107,266589
6680,926392,445021,93,0,High Volume,Stable,644,277917,167104
6681,1508374,256288,89,0,Stable,Stable,572,256288,0
6682,885987,151009,83,0,High Volume,Growth,641,151009,0
6683,2060090,927099,82,0,High Volume,Stable,593,412018,515081
6684,1262549,501866,99,0,High Volume,Stable,643,378764,123102
6685,600051,280191,99,0,Unstable,Growth,607,180015,100176
6686,5411932,424342,97,0,Low Volume,Growth,622,424342,0
6687,1331560,442731,90,1,High Volume,Stable,596,266312,176419
6688,718909,82734,85,0,High Volume,Growth,656,82734,0
6689,1733049,479628,97,0,Stable,Stable,605,479628,0
6690,2094232,251488,98,0,High Volume,Stable,639,251488,0
6691,500000,53818,94,1,Stable,Stable,524,53818,0
6692,2585212,143417,93,0,Low Volume,Growth,600,143417,0
6693,857927,286211,94,2,Stable,Growth,562,171585,114626
6694,7793675,1648831,95,0,Low Volume,Stable,550,1558735,90096
6695,3015175,293481,92,1,Low Volume,Declining,437,293481,0
6696,1439894,281178,93,0,Stable,Growth,648,281178,0
6697,1092376,137667,91,0,Low Volume,Stable,544,137667,0
6698,1823058,863697,98,0,High Volume,Growth,687,546917,316780
6699,3237243,628032,79,0,High Volume,Growth,630,628032,0
6700,1942730,389088,91,0,Low Volume,Declining,477,388546,542
6701,1666561,713182,92,0,High Volume,Stable,632,499968,213214
6702,2077542,709460,98,0,High Volume,Declining,589,415508,293952
6703,1223117,452036,94,0,Stable,Stable,565,244623,207413
6704,1506704,506555,98,0,Low Volume,Growth,616,452011,54544
6705,500000,237894,99,0,Unstable,Stable,526,100000,137894
6706,4320929,618543,97,0,Stable,Stable,601,618543,0
6707,2518158,1246659,92,0,Unstable,Growth,562,503631,743028
6708,1067933,452729,84,1,Low Volume,Stable,500,213586,239143
6709,9056452,2853123,98,0,High Volume,Stable,650,2716935,136188
6710,2125703,739888,98,1,Stable,Growth,623,637710,102178
6711,865519,295983,98,1,Stable,Declining,498,173103,122880
6712,3934876,300146,93,0,High Volume,Stable,632,300146,0
6713,2726253,403778,97,0,Stable,Stable,605,403778,0
6714,2718699,1312212,90,0,Low Volume,Growth,582,543739,768473
6715,1410416,409675,92,0,Stable,Declining,519,282083,127592
6716,2843074,626213,88,1,Unstable,Stable,449,568614,57599
6717,1608147,631869,89,0,Stable,Growth,602,482444,149425
6718,3093313,884791,93,1,High Volume,Stable,600,884791,0
6719,500000,27962,92,0,High Volume,Growth,676,27962,0
6720,1401286,534320,97,0,Stable,Growth,641,420385,113935
6721,7863356,2984127,94,1,Stable,Declining,501,1572671,1411456
6722,1073405,133442,96,0,High Volume,Declining,589,133442,0
6723,1223137,587714,92,0,Stable,Growth,624,366941,220773
6724,1385582,208888,94,0,Stable,Stable,563,208888,0
6725,750245,192053,94,0,Low Volume,Growth,614,192053,0
6726,500000,50816,87,0,Stable,Growth,591,50816,0
6727,1648755,530037,94,1,Unstable,Growth,535,329751,200286
6728,2210408,483975,98,1,Stable,Growth,604,483975,0
6729,1901200,397214,98,0,High Volume,Stable,663,397214,0
6730,1765770,745401,94,0,Stable,Stable,571,353154,392247
6731,2052220,111441,92,1,Low Volume,Growth,547,111441,0
6732,4494087,1838423,85,0,High Volume,Growth,657,1348226,490197
6733,1702559,522944,95,0,Stable,Growth,626,510767,12177
6734,1252602,618465,93,0,High Volume,Stable,624,375780,242685
6735,1583423,499173,92,0,Unstable,Growth,548,316684,182489
6736,3151778,236133,91,0,Stable,Growth,604,236133,0
6737,6135619,446614,83,0,High Volume,Growth,634,446614,0
6738,1199584,536716,93,1,High Volume,Growth,640,359875,176841
6739,2146066,919689,95,0,Low Volume,Stable,537,429213,490476
6740,2599126,534512,94,1,Low Volume,Growth,550,519825,14687
6741,896217,294062,98,1,Stable,Growth,604,268865,25197
6742,2015411,544798,92,0,High Volume,Stable,642,544798,0
6743,613822,297841,92,1,Stable,Growth,598,122764,175077
6744,500000,238741,92,0,Low Volume,Growth,576,100000,138741
6745,2658831,1310079,95,1,Stable,Stable,525,531766,778313
6746,1458472,641585,97,1,Low Volume,Growth,557,291694,349891
6747,2331038,1070642,86,0,Low Volume,Declining,494,466207,604435
6748,1954576,288838,96,1,Stable,Growth,617,288838,0
6749,907891,384903,95,0,Stable,Declining,555,181578,203325
6750,1912260,705597,89,0,Stable,Declining,508,382452,323145
6751,739344,357291,95,1,Stable,Declining,506,147868,209423
6752,6033138,1852583,88,0,Low Volume,Growth,590,1206627,645956
6753,670128,59189,90,1,Stable,Growth,588,59189,0
6754,1695303,540513,84,0,Stable,Declining,483,339060,201453
6755,861287,309169,90,1,High Volume,Declining,528,172257,136912
6756,3129353,466726,80,1,High Volume,Stable,554,466726,0
6757,1520964,345793,84,0,High Volume,Stable,616,345793,0
6758,1309383,418121,96,0,Stable,Declining,518,261876,156245
6759,3923761,856744,98,0,High Volume,Growth,701,856744,0
6760,2029996,444014,93,0,Stable,Declining,526,405999,38015
6761,2997579,329401,87,0,High Volume,Growth,658,329401,0
6762,904321,428048,91,0,High Volume,Growth,676,271296,156752
6763,644446,249866,92,0,Stable,Stable,584,128889,120977
6764,2160319,109225,92,1,Low Volume,Stable,504,109225,0
6765,1536354,606132,90,0,Low Volume,Stable,550,307270,298862
6766,3272772,1253170,87,0,Low Volume,Growth,591,654554,598616
6767,1859974,101143,93,1,Unstable,Growth,530,101143,0
6768,2336256,505383,93,2,High Volume,Stable,557,467251,38132
6769,541065,174784,90,0,Stable,Growth,619,162319,12465
6770,8982147,2279110,92,0,High Volume,Stable,607,2279110,0
6771,1738627,695614,98,1,Unstable,Declining,427,347725,347889
6772,3464468,836517,96,1,High Volume,Declining,546,692893,143624
6773,1015739,121115,95,1,Stable,Growth,581,121115,0
6774,2536785,1241470,79,0,Unstable,Growth,522,507357,734113
6775,699222,111119,98,0,Low Volume,Growth,626,111119,0
6776,2846652,1061692,90,1,High Volume,Growth,648,853995,207697
6777,1491392,170646,88,0,High Volume,Stable,613,170646,0
6778,2029606,401975,93,0,Low Volume,Growth,582,401975,0
6779,3465541,862616,80,1,High Volume,Growth,594,693108,169508
6780,739676,100969,94,2,Low Volume,Stable,481,100969,0
6781,1146709,289523,93,0,Unstable,Growth,587,229341,60182
6782,2858648,345105,98,1,High Volume,Declining,547,345105,0
6783,10623480,3203542,98,0,High Volume,Stable,629,3187044,16498
6784,1775396,619029,93,0,High Volume,Growth,680,532618,86411
6785,3181645,248472,95,0,High Volume,Growth,682,248472,0
6786,1820138,804518,97,1,Stable,Growth,595,364027,440491
6787,9377244,1250112,96,0,Low Volume,Declining,508,1250112,0
6788,500000,75707,85,0,Stable,Stable,570,75707,0
6789,2138675,743419,98,0,Stable,Growth,635,641602,101817
6790,540130,140940,95,0,High Volume,Declining,591,108026,32914
6791,500000,137364,93,0,High Volume,Growth,669,137364,0
6792,2515469,270840,97,0,Stable,Stable,601,270840,0
6793,2216851,914631,93,0,Low Volume,Stable,529,443370,471261
6794,1578729,517309,90,0,Stable,Declining,524,315745,201564
6795,1821270,202019,88,2,Unstable,Declining,378,202019,0
6796,23644464,5161580,86,0,High Volume,Stable,604,5161580,0
6797,1612764,668788,84,0,Low Volume,Growth,558,322552,346236
6798,2981984,911771,83,1,Stable,Declining,470,596396,315375
6799,1179390,116632,93,0,Low Volume,Declining,503,116632,0
6800,2510986,546766,90,1,Unstable,Stable,467,502197,44569
6801,1638699,260901,94,0,Low Volume,Declining,516,260901,0
6802,1427714,403842,95,0,Stable,Stable,590,285542,118300
6803,8496109,3649185,98,1,Stable,Growth,595,1699221,1949964
6804,5084707,1252466,93,0,Stable,Growth,647,1252466,0
6805,2211977,541943,99,1,Stable,Growth,600,541943,0
6806,500000,228704,95,0,Low Volume,Growth,592,100000,128704
6807,1485397,459409,90,1,Low Volume,Declining,451,297079,162330
6808,17234471,5252825,91,0,High Volume,Declining,564,3446894,1805931
6809,1648656,276742,98,1,High Volume,Growth,665,276742,0
6810,4792554,1550273,91,0,Stable,Declining,515,958510,591763
6811,6284230,1942831,97,1,Stable,Declining,513,1256846,685985
6812,2362359,539995,85,1,High Volume,Growth,595,472471,67524
6813,1011093,501313,82,0,Stable,Declining,503,202218,299095
6814,500000,223425,77,0,Stable,Growth,563,100000,123425
6815,3427462,1327503,97,1,Stable,Stable,546,685492,642011
6816,1033225,301501,99,0,Unstable,Stable,548,206645,94856
6817,2282816,588800,94,0,Low Volume,Growth,591,456563,132237
6818,729521,97175,93,0,Stable,Growth,609,97175,0
6819,1603677,300821,86,0,Low Volume,Growth,564,300821,0
6820,2036973,811290,92,0,Low Volume,Declining,482,407394,403896
6821,2458040,624802,80,1,Stable,Stable,483,491608,133194
6822,812720,363303,91,0,High Volume,Growth,656,243816,119487
6823,5165584,602101,97,0,Unstable,Declining,485,602101,0
6824,1229950,342856,95,0,Unstable,Declining,459,245990,96866
6825,519397,177184,92,0,High Volume,Growth,662,155819,21365
6826,1817152,513494,97,1,Low Volume,Stable,503,363430,150064
6827,2038042,917429,83,0,High Volume,Growth,663,611412,306017
6828,2254574,1116698,94,2,High Volume,Stable,542,450914,665784
6829,5895535,602085,94,0,Stable,Declining,523,602085,0
6830,1641040,178020,93,0,Stable,Growth,647,178020,0
6831,1801814,195760,90,0,Stable,Growth,615,195760,0
6832,820322,292469,94,0,Stable,Stable,602,246096,46373
6833,3822605,832197,96,0,High Volume,Stable,624,832197,0
6834,2297764,873131,95,0,Stable,Growth,635,689329,183802
6835,1416894,329374,96,2,Low Volume,Growth,517,283378,45996
6836,500000,166212,87,1,Stable,Growth,568,100000,66212
6837,6296659,2496223,97,0,Stable,Stable,599,1259331,1236892
6838,742558,220315,96,0,Stable,Growth,643,220315,0
6839,1235489,361722,88,0,Low Volume,Growth,593,247097,114625
6840,2641020,236914,93,0,Stable,Growth,609,236914,0
6841,761278,178787,96,0,High Volume,Declining,605,178787,0
6842,600304,177450,96,0,Unstable,Growth,572,120060,57390
6843,500000,128946,88,1,High Volume,Growth,628,128946,0
6844,3529962,1607375,87,1,Stable,Growth,569,705992,901383
6845,1281896,587030,93,2,Low Volume,Growth,526,256379,330651
6846,20620908,8657953,92,0,Low Volume,Stable,558,4124181,4533772
6847,894944,195889,97,0,Low Volume,Growth,605,195889,0
6848,948692,353658,92,1,High Volume,Growth,629,284607,69051
6849,1261341,287434,86,0,Low Volume,Declining,495,252268,35166
6850,2408483,372513,94,0,Low Volume,Stable,566,372513,0
6851,1361146,278091,90,0,Stable,Stable,581,272229,5862
6852,3236056,265143,96,0,High Volume,Declining,581,265143,0
6853,906303,180626,97,0,Stable,Growth,633,180626,0
6854,656532,168948,88,1,High Volume,Declining,544,131306,37642
6855,500000,239983,95,0,Unstable,Growth,575,100000,139983
6856,500000,95517,84,1,Low Volume,Growth,523,95517,0
6857,1310009,597500,97,0,Stable,Declining,535,262001,335499
6858,1558471,238425,89,0,Low Volume,Stable,540,238425,0
6859,1196427,162638,93,0,Stable,Growth,628,162638,0
6860,5361341,1520197,92,1,High Volume,Growth,616,1520197,0
6861,5295798,1867458,88,1,High Volume,Declining,517,1059159,808299
6862,1516867,106104,94,0,Unstable,Stable,503,106104,0
6863,500000,74740,81,0,Low Volume,Stable,500,74740,0
6864,1260017,321377,87,1,Unstable,Growth,501,252003,69374
6865,1227074,244129,90,0,High Volume,Growth,669,244129,0
6866,1172082,434467,87,0,High Volume,Growth,657,351624,82843
6867,1134639,317724,92,0,High Volume,Growth,667,317724,0
6868,1175530,143605,98,0,Low Volume,Growth,613,143605,0
6869,1455364,658566,85,0,High Volume,Declining,544,291072,367494
6870,1192506,216807,87,1,Stable,Stable,521,216807,0
6871,2342333,887765,85,0,High Volume,Growth,637,702699,185066
6872,2645300,1060665,98,0,Unstable,Stable,517,529060,531605
6873,956928,462599,94,0,Stable,Stable,585,191385,271214
6874,5481297,1503675,84,0,Low Volume,Stable,538,1096259,407416
6875,905235,296126,91,0,Stable,Stable,579,181047,115079
6876,543486,109075,90,0,Stable,Growth,630,109075,0
6877,2688845,955026,81,2,Stable,Growth,502,537769,417257
6878,1031035,266546,97,0,High Volume,Growth,674,266546,0
6879,2563882,633134,88,0,Stable,Growth,605,633134,0
6880,500000,217480,97,1,High Volume,Growth,645,150000,67480
6881,6040303,438381,84,0,Stable,Growth,607,438381,0
6882,3395069,1517199,95,0,Stable,Declining,548,679013,838186
6883,596968,258745,92,0,Stable,Declining,506,119393,139352
6884,607422,168781,93,0,Low Volume,Stable,546,121484,47297
6885,7555699,2044506,94,1,High Volume,Growth,630,2044506,0
6886,1099203,233925,97,0,Stable,Declining,554,219840,14085
6887,1017289,505977,93,0,Stable,Declining,538,203457,302520
6888,500000,50013,97,1,High Volume,Growth,634,50013,0
6889,1497605,472639,86,0,High Volume,Stable,611,449281,23358
6890,1652540,589555,91,0,High Volume,Growth,678,495762,93793
6891,3514453,1653369,93,0,Low Volume,Declining,485,702890,950479
6892,647411,259671,94,0,High Volume,Growth,682,194223,65448
6893,587582,199620,90,0,Stable,Growth,613,176274,23346
6894,2844137,291710,99,0,Stable,Growth,660,291710,0
6895,4436534,967963,95,0,Unstable,Growth,564,887306,80657
6896,564152,63455,95,2,Low Volume,Growth,515,63455,0
6897,4710060,2103257,91,0,High Volume,Stable,642,1413018,690239
6898,2043212,791396,95,0,Stable,Declining,521,408642,382754
6899,4748998,1856343,87,0,High Volume,Stable,625,1424699,431644
6900,1874446,643901,97,0,High Volume,Stable,660,562333,81568
6901,500000,139085,90,0,High Volume,Stable,627,139085,0
6902,1755784,206282,86,0,Stable,Growth,602,206282,0
6903,4630221,918463,94,0,High Volume,Declining,599,918463,0
6904,969953,108258,98,1,Stable,Stable,574,108258,0
6905,1453708,546901,99,1,Low Volume,Stable,507,290741,256160
6906,1722166,210282,95,0,Low Volume,Declining,498,210282,0
6907,500000,182976,87,0,Stable,Declining,503,100000,82976
6908,7550151,2729492,98,0,Stable,Declining,545,1510030,1219462
6909,964051,247459,93,0,Stable,Growth,629,247459,0
6910,2971532,329403,90,0,Stable,Declining,540,329403,0
6911,1849894,354551,99,1,Stable,Declining,523,354551,0
6912,5422650,1052221,92,0,Stable,Stable,573,1052221,0
6913,2743774,1001953,87,2,Stable,Stable,501,548754,453199
6914,1643043,166250,83,0,High Volume,Declining,537,166250,0
6915,970132,410444,78,0,Stable,Growth,602,291039,119405
6916,3753805,1473193,94,0,Low Volume,Growth,612,1126141,347052
6917,500000,66919,91,0,Low Volume,Growth,608,66919,0
6918,3324109,1241967,92,0,High Volume,Declining,560,664821,577146
6919,823043,288749,85,0,Stable,Growth,615,246912,41837
6920,5399554,2087761,90,0,Stable,Growth,600,1619866,467895
6921,2255855,304581,93,0,Unstable,Stable,520,304581,0
6922,3319415,401369,86,1,High Volume,Stable,562,401369,0
6923,2117170,331163,99,1,High Volume,Declining,562,331163,0
6924,500000,107321,93,0,High Volume,Growth,687,107321,0
6925,995914,405486,87,0,High Volume,Growth,681,298774,106712
6926,3395330,1297239,87,1,Low Volume,Declining,447,679066,618173
6927,2265542,1056769,98,0,Stable,Declining,557,453108,603661
6928,5100208,389571,100,0,Stable,Growth,650,389571,0
6929,2737675,151121,91,0,Low Volume,Growth,584,151121,0
6930,914963,333607,87,0,High Volume,Growth,675,274488,59119
6931,1048791,184251,94,1,Unstable,Stable,495,184251,0
6932,2152916,431306,84,0,Low Volume,Declining,484,430583,723
6933,500000,148030,85,1,High Volume,Stable,567,100000,48030
6934,7562811,726680,91,0,Stable,Stable,560,726680,0
6935,2823245,957680,88,0,Low Volume,Growth,601,846973,110707
6936,5291581,1038824,96,0,Stable,Growth,636,1038824,0
6937,559902,187411,92,0,Unstable,Declining,480,111980,75431
6938,5366316,2282311,98,0,Low Volume,Stable,570,1073263,1209048
6939,11818766,1500984,93,1,Low Volume,Growth,568,1500984,0
6940,689207,323164,98,0,High Volume,Growth,693,206762,116402
6941,3675212,1061437,86,1,High Volume,Stable,575,735042,326395
6942,1984521,923432,93,0,Stable,Growth,618,595356,328076
6943,576340,82692,98,0,Stable,Growth,648,82692,0
6944,2941138,947203,96,1,High Volume,Stable,591,588227,358976
6945,3862722,895183,85,0,Low Volume,Growth,555,772544,122639
6946,1225793,488356,94,0,Low Volume,Declining,511,245158,243198
6947,5039076,1625903,98,0,Stable,Declining,536,1007815,618088
6948,522609,142428,93,0,Stable,Stable,583,104521,37907
6949,599706,276371,96,0,Stable,Stable,579,119941,156430
6950,2211713,485919,90,0,High Volume,Declining,573,442342,43577
6951,2023437,301474,93,0,High Volume,Growth,664,301474,0
6952,1117653,361723,83,0,Low Volume,Declining,457,223530,138193
6953,3789238,1253528,91,0,Stable,Stable,590,757847,495681
6954,3031947,750688,89,0,Stable,Growth,619,750688,0
6955,3939291,1059569,95,0,Stable,Growth,620,1059569,0
6956,1796751,865673,95,0,Stable,Stable,599,359350,506323
6957,3210908,1219209,99,0,High Volume,Declining,604,963272,255937
6958,1388146,138496,89,0,Low Volume,Growth,571,138496,0
6959,10252734,1491348,96,1,Stable,Stable,547,1491348,0
6960,1035053,506151,88,0,High Volume,Growth,659,310515,195636
6961,10683787,4026821,88,0,High Volume,Growth,663,3205136,821685
6962,2038878,941493,86,0,High Volume,Growth,659,611663,329830
6963,659734,123197,97,1,High Volume,Declining,553,123197,0
6964,5923651,2273735,93,0,High Volume,Growth,670,1777095,496640
6965,2192869,814215,93,0,High Volume,Growth,691,657860,156355
6966,3917245,715330,89,0,High Volume,Growth,685,715330,0
6967,5278142,1572186,97,0,Stable,Stable,598,1055628,516558
6968,2598291,863508,99,1,High Volume,Growth,640,779487,84021
6969,1234538,329016,97,0,Stable,Growth,659,329016,0
6970,4327804,1827330,96,0,Low Volume,Growth,595,865560,961770
6971,1983958,842768,92,0,Stable,Growth,626,595187,247581
6972,3432112,1485316,90,0,Low Volume,Growth,581,686422,798894
6973,500000,205770,97,0,High Volume,Growth,705,200000,5770
6974,2835093,764448,86,0,Stable,Declining,503,567018,197430
6975,1189604,263672,92,0,Stable,Declining,513,237920,25752
6976,7441982,3156288,98,1,Unstable,Stable,478,1488396,1667892
6977,3264019,883213,92,0,Stable,Growth,617,883213,0
6978,2402178,386431,93,0,Stable,Growth,634,386431,0
6979,2925711,814239,93,1,Stable,Growth,605,814239,0
6980,892023,101541,92,0,Stable,Growth,646,101541,0
6981,7265193,2624429,83,1,Stable,Stable,497,1453038,1171391
6982,9753106,1961979,87,0,Stable,Growth,631,1961979,0
6983,2715077,454223,88,0,Stable,Declining,521,454223,0
6984,7076733,3399867,97,0,Low Volume,Growth,630,2123019,1276848
6985,1257557,502515,84,1,High Volume,Growth,599,251511,251004
6986,1047911,423546,88,0,Low Volume,Stable,515,209582,213964
6987,2048749,677470,91,2,Low Volume,Declining,414,409749,267721
6988,2807915,1200742,89,0,Low Volume,Declining,496,561583,639159
6989,1446722,566570,86,0,High Volume,Growth,653,434016,132554
6990,3048666,973891,92,0,High Volume,Stable,629,914599,59292
6991,2533498,1222428,94,0,Unstable,Growth,578,506699,715729
6992,892119,121522,90,0,High Volume,Stable,632,121522,0
6993,3002736,1424861,94,0,Stable,Growth,617,900820,524041
6994,3956311,912512,92,0,High Volume,Growth,685,912512,0
6995,2274283,654492,95,0,Low Volume,Growth,610,654492,0
6996,4985870,524677,90,1,High Volume,Growth,623,524677,0
6997,748688,219402,91,0,High Volume,Growth,683,219402,0
6998,2883053,937116,89,1,Stable,Stable,522,576610,360506
6999,777451,387921,95,0,High Volume,Stable,635,233235,154686
7000,813202,397523,94,0,Stable,Declining,513,162640,234883
7001,1196912,580357,84,1,Stable,Stable,499,239382,340975
7002,933179,192958,87,1,Stable,Stable,507,186635,6323
7003,1279018,634482,94,0,Low Volume,Growth,607,383705,250777
7004,1670577,425939,91,1,Stable,Stable,533,334115,91824
7005,3873711,1678581,86,0,High Volume,Declining,555,774742,903839
7006,1533515,225954,96,0,High Volume,Growth,685,225954,0
7007,557657,154819,86,1,Low Volume,Stable,468,111531,43288
7008,4935943,2392478,90,0,Low Volume,Stable,546,987188,1405290
7009,1014928,483272,92,0,Low Volume,Growth,583,202985,280287
7010,1891770,676650,99,0,High Volume,Stable,654,567531,109119
7011,2834084,1159187,93,1,High Volume,Growth,656,850225,308962
7012,2326064,300974,96,0,Stable,Stable,569,300974,0
7013,4758027,1783053,92,0,High Volume,Growth,677,1427408,355645
7014,2908658,954397,92,1,High Volume,Growth,635,872597,81800
7015,995452,90784,91,0,Low Volume,Declining,486,90784,0
7016,11328698,1143310,97,0,Stable,Stable,605,1143310,0
7017,2316266,228846,98,0,High Volume,Growth,704,228846,0
7018,1762296,662554,89,0,Stable,Stable,587,352459,310095
7019,4287183,487761,97,0,High Volume,Growth,673,487761,0
7020,2420684,630539,93,1,High Volume,Growth,626,630539,0
7021,2728827,574805,92,1,High Volume,Growth,641,574805,0
7022,14559397,4334724,95,1,Stable,Declining,498,2911879,1422845
7023,1591047,585369,90,0,Stable,Growth,614,477314,108055
7024,1537689,550685,84,0,High Volume,Growth,668,461306,89379
7025,2176574,613759,96,0,High Volume,Stable,655,613759,0
7026,4672537,1209957,91,0,Stable,Growth,617,1209957,0
7027,594082,136055,90,1,Low Volume,Growth,564,118816,17239
7028,500000,218930,94,0,Unstable,Stable,539,100000,118930
7029,1239611,246538,90,0,High Volume,Stable,616,246538,0
7030,536521,89446,89,0,Low Volume,Declining,497,89446,0
7031,1411460,542695,92,0,High Volume,Growth,657,423438,119257
7032,2963850,628021,93,0,High Volume,Growth,663,628021,0
7033,972282,419199,94,0,Stable,Stable,563,194456,224743
7034,633198,125088,95,2,Stable,Stable,486,125088,0
7035,2095850,766819,96,0,Stable,Declining,543,419170,347649
7036,3953195,277906,98,0,High Volume,Stable,661,277906,0
7037,510947,114198,88,0,Unstable,Stable,520,102189,12009
7038,3821624,781345,96,1,High Volume,Stable,587,764324,17021
7039,3812688,1591818,90,0,High Volume,Growth,676,1143806,448012
7040,4253565,2063723,94,1,Stable,Growth,579,850713,1213010
7041,5255492,1352746,92,0,Unstable,Growth,555,1051098,301648
7042,11543247,4861742,97,0,Unstable,Stable,545,2308649,2553093
7043,1491252,544102,96,0,High Volume,Declining,591,298250,245852
7044,2164408,1050438,98,2,High Volume,Stable,567,432881,617557
7045,1420969,589700,94,1,Stable,Growth,602,426290,163410
7046,1985897,168533,87,0,Stable,Growth,594,168533,0
7047,6758413,2507214,94,0,Stable,Growth,651,2027523,479691
7048,676027,196707,95,0,High Volume,Declining,578,135205,61502
7049,995659,57147,91,0,High Volume,Growth,688,57147,0
7050,5966940,973153,99,0,High Volume,Declining,602,973153,0
7051,4484014,2084124,93,0,Low Volume,Growth,590,896802,1187322
7052,1482877,692100,93,0,Stable,Stable,585,296575,395525
7053,3927531,1608256,91,0,Low Volume,Declining,478,785506,822750
7054,2605077,1281179,95,0,Stable,Stable,591,521015,760164
7055,6584439,2719013,99,2,Low Volume,Growth,530,1316887,1402126
7056,2104540,114891,83,1,High Volume,Growth,610,114891,0
7057,4504132,808606,91,0,Low Volume,Growth,592,808606,0
7058,16413415,1046862,93,0,Low Volume,Growth,581,1046862,0
7059,3199418,295462,92,1,High Volume,Stable,574,295462,0
7060,2062568,306247,93,0,High Volume,Stable,624,306247,0
7061,3534059,977525,97,0,High Volume,Declining,579,706811,270714
7062,1480330,638599,96,0,Low Volume,Growth,619,444099,194500
7063,13394760,5865365,99,0,High Volume,Declining,610,4018428,1846937
7064,2289987,749492,90,0,High Volume,Stable,624,686996,62496
7065,1593835,745403,99,1,Unstable,Growth,553,318767,426636
7066,1016066,279447,87,0,Stable,Growth,617,279447,0
7067,4769615,2146643,87,1,Low Volume,Stable,472,953923,1192720
7068,3967909,1009156,95,0,Low Volume,Growth,606,1009156,0
7069,1331899,232751,91,2,Stable,Growth,524,232751,0
7070,3144486,1453966,91,0,Low Volume,Growth,573,628897,825069
7071,593122,133198,93,0,Stable,Growth,648,133198,0
7072,2298981,635741,97,0,Stable,Growth,659,635741,0
7073,2848221,563912,95,1,Stable,Growth,584,563912,0
7074,7770646,2706337,86,0,Unstable,Growth,539,1554129,1152208
7075,1070188,532701,97,0,Low Volume,Growth,627,321056,211645
7076,713058,43840,91,0,High Volume,Growth,669,43840,0
7077,968649,440669,92,0,High Volume,Stable,608,290594,150075
7078,680610,35233,95,1,Low Volume,Growth,565,35233,0
7079,5776600,1235629,99,1,High Volume,Growth,648,1235629,0
7080,6844195,861500,93,0,Stable,Growth,635,861500,0
7081,2561678,1001114,83,0,Stable,Growth,593,512335,488779
7082,5267340,383330,87,1,High Volume,Stable,587,383330,0
7083,2207049,660058,96,0,Low Volume,Stable,578,441409,218649
7084,1837489,335740,84,0,Low Volume,Growth,554,335740,0
7085,1519011,167322,92,0,Unstable,Declining,450,167322,0
7086,1546782,614565,81,0,High Volume,Growth,656,464034,150531
7087,574789,84975,98,1,High Volume,Growth,667,84975,0
7088,2449523,369030,96,0,Stable,Growth,638,369030,0
7089,1919802,333632,96,0,Low Volume,Growth,600,333632,0
7090,3599439,1130386,96,0,High Volume,Growth,692,1079831,50555
7091,2136798,741148,95,0,High Volume,Declining,578,427359,313789
7092,1740768,100827,94,0,Stable,Growth,629,100827,0
7093,987612,156874,89,0,Stable,Growth,599,156874,0
7094,2100577,512408,85,0,Stable,Stable,537,420115,92293
7095,3578985,713612,98,0,Stable,Growth,655,713612,0
7096,794389,355788,93,1,Low Volume,Stable,506,158877,196911
7097,2126481,860095,95,0,Stable,Growth,646,637944,222151
7098,2389117,792352,93,2,Stable,Growth,560,477823,314529
7099,1116320,225630,94,0,Low Volume,Growth,617,225630,0
7100,1238876,452565,92,0,High Volume,Growth,684,371662,80903
7101,2384473,1024458,99,0,Low Volume,Stable,585,476894,547564
7102,800717,254367,93,0,Stable,Growth,645,240215,14152
7103,2623288,1057205,87,1,Stable,Growth,585,524657,532548
7104,968706,374983,87,0,Stable,Growth,617,290611,84372
7105,4640269,1425870,83,0,High Volume,Stable,618,1392080,33790
7106,12868103,2451148,85,0,High Volume,Growth,658,2451148,0
7107,995892,384018,97,1,High Volume,Stable,616,298767,85251
7108,3039995,434897,98,1,Stable,Growth,618,434897,0
7109,1108598,444293,95,0,Unstable,Growth,594,221719,222574
7110,4559682,1878799,86,0,Stable,Stable,543,911936,966863
7111,720567,302613,89,0,Stable,Stable,553,144113,158500
7112,2912346,765400,91,0,Low Volume,Declining,486,582469,182931
7113,986194,134730,93,1,Unstable,Growth,525,134730,0
7114,1680181,159408,94,0,Stable,Declining,538,159408,0
7115,869071,334169,81,0,Stable,Stable,528,173814,160355
7116,3828105,1718121,91,0,High Volume,Declining,555,765621,952500
7117,1015017,348026,99,0,High Volume,Stable,665,304505,43521
7118,3083486,354206,94,0,Stable,Stable,596,354206,0
7119,1505629,708705,91,0,High Volume,Stable,604,451688,257017
7120,1809248,895751,91,1,Low Volume,Growth,551,361849,533902
7121,2231545,546774,92,0,Low Volume,Declining,498,446309,100465
7122,1077916,342423,88,0,Stable,Stable,560,215583,126840
7123,2346167,937887,93,0,Stable,Declining,517,469233,468654
7124,6744701,2572263,98,0,Stable,Growth,663,2023410,548853
7125,1063977,516565,88,0,Low Volume,Declining,472,212795,303770
7126,5062890,514883,92,0,Low Volume,Declining,510,514883,0
7127,6572982,2046341,80,0,High Volume,Growth,628,1971894,74447
7128,1032069,372958,81,0,Low Volume,Growth,554,206413,166545
7129,619059,278913,85,1,Low Volume,Stable,467,123811,155102
7130,2524538,1119252,90,0,High Volume,Stable,636,757361,361891
7131,1279620,627142,92,0,Low Volume,Stable,546,255924,371218
7132,8840753,2479259,95,1,High Volume,Declining,552,1768150,711109
7133,2038747,864107,96,0,High Volume,Stable,650,611624,252483
7134,1043656,252854,93,0,Stable,Growth,642,252854,0
7135,791965,190104,94,0,Stable,Declining,533,158393,31711
7136,4741784,777685,93,1,Stable,Growth,605,777685,0
7137,1255510,525063,95,0,Unstable,Growth,584,251102,273961
7138,2053514,1013649,85,1,High Volume,Growth,625,616054,397595
7139,4259414,704310,91,1,Stable,Declining,478,704310,0
7140,1345927,101293,92,0,Stable,Declining,540,101293,0
7141,1911229,796971,90,0,Low Volume,Growth,570,382245,414726
7142,1956652,643941,98,0,High Volume,Growth,682,586995,56946
7143,3425163,1650464,91,0,High Volume,Growth,653,1027548,622916
7144,3180648,520060,96,1,Unstable,Declining,440,520060,0
7145,1662626,136273,96,0,Stable,Stable,604,136273,0
7146,2086334,566646,91,0,Unstable,Growth,560,417266,149380
7147,1472654,130271,92,1,Stable,Stable,519,130271,0
7148,607988,102024,96,1,Stable,Stable,537,102024,0
7149,2436518,259952,93,1,Stable,Growth,595,259952,0
7150,9009169,1359119,90,0,Unstable,Growth,541,1359119,0
7151,977765,95591,99,0,High Volume,Growth,680,95591,0
7152,1068297,511990,96,0,High Volume,Stable,657,320489,191501
7153,987980,173245,99,0,Stable,Stable,609,173245,0
7154,3540128,884161,96,1,High Volume,Growth,668,884161,0
7155,2838506,1289747,95,1,Low Volume,Growth,552,567701,722046
7156,1746579,619677,94,0,Unstable,Stable,516,349315,270362
7157,951300,312138,92,0,Low Volume,Stable,532,190260,121878
7158,2134838,784560,85,0,High Volume,Declining,564,426967,357593
7159,567106,239869,97,1,Low Volume,Stable,524,113421,126448
7160,2223829,989495,96,0,Stable,Growth,637,667148,322347
7161,3981700,1350544,87,0,High Volume,Declining,545,796340,554204
7162,728717,328289,93,0,Stable,Growth,615,218615,109674
7163,581860,169280,88,1,Low Volume,Growth,560,116372,52908
7164,7014923,1226074,86,0,High Volume,Declining,539,1226074,0
7165,1215410,542115,85,0,Stable,Declining,494,243082,299033
7166,4919701,1444733,87,0,High Volume,Stable,603,1444733,0
7167,1752935,802427,91,0,Low Volume,Growth,593,350587,451840
7168,1741811,118575,91,0,High Volume,Growth,655,118575,0
7169,2815725,644469,93,0,Stable,Declining,522,563145,81324
7170,977546,465813,94,0,Stable,Declining,527,195509,270304
7171,2204470,357879,84,0,Stable,Declining,489,357879,0
7172,1461258,692185,82,0,High Volume,Growth,649,438377,253808
7173,689420,330409,92,0,Stable,Declining,519,137884,192525
7174,2597307,1160903,98,1,Stable,Stable,539,519461,641442
7175,1606155,487710,98,0,Stable,Declining,547,321231,166479
7176,1748695,596520,92,1,Stable,Stable,544,349739,246781
7177,753038,332336,93,0,High Volume,Growth,684,225911,106425
7178,7082378,2826957,83,0,Stable,Stable,562,1416475,1410482
7179,3998266,1333591,89,0,Low Volume,Growth,571,799653,533938
7180,4287973,2109754,81,1,Stable,Growth,566,857594,1252160
7181,1552915,556805,97,0,Stable,Declining,554,310583,246222
7182,500000,244483,98,0,High Volume,Declining,586,100000,144483
7183,9457644,717124,92,1,Stable,Stable,518,717124,0
7184,1888176,212481,98,0,High Volume,Growth,678,212481,0
7185,1089207,275740,88,0,Stable,Growth,615,275740,0
7186,2767462,617686,95,0,High Volume,Growth,685,617686,0
7187,5043933,2028825,86,0,High Volume,Stable,614,1513179,515646
7188,1946531,238015,92,0,High Volume,Growth,679,238015,0
7189,5514327,2697845,90,0,Stable,Declining,538,1102865,1594980
7190,4715662,904368,77,0,Low Volume,Stable,488,904368,0
7191,838102,203672,96,0,Stable,Growth,621,203672,0
7192,1156568,200821,94,0,Low Volume,Declining,517,200821,0
7193,4265328,1325296,83,0,High Volume,Growth,634,1279598,45698
7194,500000,38191,91,0,Stable,Declining,533,38191,0
7195,1759316,206464,89,0,Stable,Declining,501,206464,0
7196,631173,243386,92,0,Low Volume,Stable,531,126234,117152
7197,1354248,181368,96,0,Stable,Growth,619,181368,0
7198,1561167,243513,86,0,Stable,Growth,588,243513,0
7199,1488686,605660,96,0,Stable,Growth,646,446605,159055
7200,1274661,117250,98,0,Low Volume,Growth,616,117250,0
7201,824296,203488,86,1,Low Volume,Stable,485,164859,38629
7202,12403993,748935,89,2,Stable,Growth,519,748935,0
7203,8832685,1820092,94,0,High Volume,Growth,677,1820092,0
7204,782577,285282,94,0,High Volume,Growth,697,234773,50509
7205,7029973,636539,89,0,Low Volume,Stable,547,636539,0
7206,1440395,647818,98,0,Stable,Growth,645,432118,215700
7207,2198641,1009780,100,0,Stable,Growth,637,659592,350188
7208,1884892,183298,92,0,Stable,Growth,627,183298,0
7209,1169634,579939,82,0,Unstable,Growth,528,233926,346013
7210,4356075,801031,91,0,Stable,Stable,590,801031,0
7211,2192843,192632,93,0,Stable,Stable,587,192632,0
7212,1354251,70801,93,1,High Volume,Stable,584,70801,0
7213,698247,163275,98,0,Low Volume,Growth,603,163275,0
7214,970070,323435,87,0,Stable,Growth,624,291021,32414
7215,533330,106389,89,0,Low Volume,Growth,599,106389,0
7216,2002243,854002,94,0,High Volume,Stable,625,600672,253330
7217,761212,283531,99,0,Low Volume,Growth,628,228363,55168
7218,1603263,332794,91,0,Unstable,Growth,565,320652,12142
7219,5933243,2257239,98,1,Stable,Growth,598,1186648,1070591
7220,5175465,2449131,97,1,Stable,Growth,605,1552639,896492
7221,1932217,177558,98,0,Stable,Stable,599,177558,0
7222,1849327,347205,93,0,Unstable,Stable,510,347205,0
7223,8920831,2306005,91,0,Stable,Growth,621,2306005,0
7224,3007455,824330,85,1,High Volume,Growth,634,824330,0
7225,1525381,448444,91,3,Stable,Growth,501,305076,143368
7226,633608,117396,86,0,Stable,Growth,619,117396,0
7227,2717162,951732,84,0,Low Volume,Growth,561,543432,408300
7228,3849520,1309946,95,0,Stable,Stable,591,769904,540042
7229,1196222,370852,87,0,Unstable,Stable,503,239244,131608
7230,2502904,253276,86,0,Low Volume,Growth,598,253276,0
7231,1482353,392283,87,0,Stable,Declining,508,296470,95813
7232,1711317,359894,91,0,Stable,Stable,587,342263,17631
7233,500000,135484,84,0,Stable,Growth,594,100000,35484
7234,1660410,771825,97,1,High Volume,Growth,632,498123,273702
7235,4305894,1146397,93,1,Stable,Declining,504,861178,285219
7236,1196460,67350,95,0,Stable,Growth,636,67350,0
7237,2067852,511745,93,0,Stable,Growth,628,511745,0
7238,1082993,454090,92,1,Stable,Stable,522,216598,237492
7239,2645454,1060900,80,2,High Volume,Growth,551,529090,531810
7240,1667409,468585,89,0,Unstable,Growth,551,333481,135104
7241,935285,151887,88,0,High Volume,Growth,672,151887,0
7242,5757657,1492902,99,0,Stable,Declining,534,1151531,341371
7243,4168828,1265931,84,0,Unstable,Declining,444,833765,432166
7244,1222092,610975,92,0,Stable,Stable,568,244418,366557
7245,2952700,1003564,88,0,Low Volume,Stable,546,590540,413024
7246,3047797,1104580,97,1,High Volume,Growth,635,914339,190241
7247,3314578,898762,100,0,High Volume,Stable,648,898762,0
7248,511240,107115,92,1,High Volume,Declining,522,102248,4867
7249,4436096,1844657,97,0,Unstable,Declining,464,887219,957438
7250,1257003,342809,85,1,High Volume,Growth,631,342809,0
7251,1489182,741033,96,0,Stable,Declining,526,297836,443197
7252,16359272,4183136,91,1,Stable,Growth,581,3271854,911282
7253,2524361,203464,97,0,Low Volume,Growth,615,203464,0
7254,1455619,519889,94,0,High Volume,Growth,662,436685,83204
7255,500000,35494,84,0,High Volume,Growth,635,35494,0
7256,6027310,980798,84,0,Low Volume,Growth,569,980798,0
7257,675922,141391,98,1,Stable,Growth,590,135184,6207
7258,888464,340075,96,0,Stable,Stable,586,177692,162383
7259,1521060,414346,92,0,Stable,Stable,578,304212,110134
7260,6157180,387229,96,1,Low Volume,Stable,525,387229,0
7261,3680621,1205707,89,0,High Volume,Growth,675,1104186,101521
7262,1747558,410932,88,0,High Volume,Declining,549,349511,61421
7263,2537357,1179428,86,1,High Volume,Growth,624,761207,418221
7264,1226520,337051,86,1,High Volume,Growth,601,337051,0
7265,2217127,818206,96,0,Low Volume,Growth,610,665138,153068
7266,2102567,312212,85,0,Low Volume,Growth,584,312212,0
7267,4303830,1688987,95,0,High Volume,Growth,688,1291149,397838
7268,4298353,1609432,98,0,Low Volume,Growth,625,1289505,319927
7269,2943712,1344796,95,0,Stable,Growth,625,883113,461683
7270,1483807,96774,91,1,Stable,Declining,492,96774,0
7271,3589264,902252,87,1,High Volume,Stable,576,717852,184400
7272,1842116,655093,89,1,Stable,Growth,572,368423,286670
7273,834400,77452,91,0,Low Volume,Growth,578,77452,0
7274,1435997,337132,78,0,Stable,Declining,488,287199,49933
7275,2121474,1005506,92,1,Stable,Growth,585,424294,581212
7276,4106874,1010991,81,0,Low Volume,Declining,452,821374,189617
7277,1712008,844760,93,0,High Volume,Growth,697,513602,331158
7278,753618,56957,93,0,High Volume,Declining,559,56957,0
7279,2074837,773963,92,0,Stable,Stable,566,414967,358996
7280,2171144,676219,89,0,Stable,Stable,558,434228,241991
7281,2300576,633217,89,0,Unstable,Growth,556,460115,173102
7282,4138720,2015066,91,1,Stable,Growth,574,827744,1187322
7283,4480022,485378,89,1,High Volume,Growth,622,485378,0
7284,1232594,558611,90,0,Stable,Stable,564,246518,312093
7285,1211155,437297,92,0,Stable,Stable,581,242231,195066
7286,862716,143684,98,0,Unstable,Growth,574,143684,0
7287,3467875,1580488,89,1,Unstable,Growth,499,693575,886913
7288,6318902,1536648,96,1,Stable,Growth,579,1263780,272868
7289,1540988,641671,98,0,Stable,Stable,592,308197,333474
7290,1634513,367727,92,0,Stable,Declining,537,326902,40825
7291,6410360,2775166,95,0,Low Volume,Growth,607,1923108,852058
7292,2971110,999728,86,1,Stable,Growth,571,594222,405506
7293,2810825,318947,83,0,High Volume,Growth,641,318947,0
7294,764721,261801,89,0,Low Volume,Declining,467,152944,108857
7295,3412591,464471,89,0,Unstable,Stable,525,464471,0
7296,942877,221920,92,0,Low Volume,Growth,580,188575,33345
7297,800334,101349,95,0,High Volume,Growth,677,101349,0
7298,1502413,90005,93,0,Low Volume,Growth,615,90005,0
7299,1240923,180367,98,0,Unstable,Stable,521,180367,0
7300,1660651,483860,87,1,Stable,Growth,590,332130,151730
7301,626068,166974,90,0,High Volume,Stable,629,166974,0
7302,4269695,1177043,89,0,High Volume,Declining,574,853939,323104
7303,4887293,789098,94,0,Stable,Stable,590,789098,0
7304,500000,179161,86,0,Stable,Growth,623,150000,29161
7305,4337316,1591441,98,0,Unstable,Declining,483,867463,723978
7306,1036725,218838,81,0,Stable,Growth,577,207345,11493
7307,3935626,1757361,96,0,High Volume,Growth,674,1180687,576674
7308,1877108,637861,90,0,Stable,Stable,579,375421,262440
7309,2028933,752466,95,0,High Volume,Growth,702,752466,0
7310,1709860,298889,85,0,High Volume,Stable,591,298889,0
7311,5228858,262882,95,1,Low Volume,Growth,555,262882,0
7312,735517,323200,89,0,High Volume,Growth,657,220655,102545
7313,3224448,1354561,88,0,High Volume,Growth,663,967334,387227
7314,4785323,504547,99,0,Stable,Growth,659,504547,0
7315,3516835,767891,99,2,Stable,Growth,561,703367,64524
7316,12733656,4426253,96,0,Low Volume,Growth,591,2546731,1879522
7317,1298659,446024,85,1,Stable,Growth,554,259731,186293
7318,4264536,1864275,90,0,Stable,Stable,587,852907,1011368
7319,1821421,206040,95,0,Stable,Growth,654,206040,0
7320,5318622,1294940,96,0,High Volume,Declining,570,1063724,231216
7321,1970600,184746,92,0,High Volume,Growth,679,184746,0
7322,1453812,327570,83,0,Stable,Growth,580,290762,36808
7323,5636973,320171,79,1,High Volume,Growth,599,320171,0
7324,1338086,607789,90,1,Stable,Growth,578,267617,340172
7325,640382,183898,91,1,Stable,Declining,470,128076,55822
7326,1311291,567017,93,0,Stable,Growth,634,393387,173630
7327,3253449,250376,89,0,Low Volume,Growth,584,250376,0
7328,6038287,919970,97,0,Stable,Growth,629,919970,0
7329,2167107,361302,91,1,High Volume,Growth,652,361302,0
7330,5691917,1275053,96,1,High Volume,Stable,613,1275053,0
7331,668947,275131,85,0,Stable,Stable,543,133789,141342
7332,1390799,311471,98,0,High Volume,Growth,706,311471,0
7333,1574014,223658,88,0,Stable,Declining,504,223658,0
7334,1809122,143365,95,0,Low Volume,Growth,625,143365,0
7335,2120740,181899,94,0,High Volume,Growth,685,181899,0
7336,3446014,1350911,88,0,Stable,Growth,617,1033804,317107
7337,1389083,347495,97,0,High Volume,Growth,702,347495,0
7338,2216019,834955,92,0,Stable,Stable,588,443203,391752
7339,1912461,682804,97,0,Unstable,Growth,600,573738,109066
7340,945329,104849,93,0,Unstable,Declining,465,104849,0
7341,1810415,206930,91,1,Unstable,Declining,428,206930,0
7342,1767492,689152,90,0,Stable,Growth,632,530247,158905
7343,1737461,650802,89,0,High Volume,Stable,598,347492,303310
7344,2033782,447664,92,0,Stable,Declining,507,406756,40908
7345,2106501,178716,95,0,High Volume,Stable,628,178716,0
7346,1403057,77791,96,0,High Volume,Growth,688,77791,0
7347,5488534,986128,92,0,High Volume,Growth,678,986128,0
7348,777948,42126,93,0,Stable,Stable,580,42126,0
7349,1113728,170994,92,0,High Volume,Growth,691,170994,0
7350,18328557,4376407,96,0,Unstable,Declining,458,3665711,710696
7351,864241,90432,98,1,Stable,Stable,565,90432,0
7352,671317,65067,84,1,High Volume,Declining,520,65067,0
7353,3568234,1617826,94,1,Stable,Growth,576,713646,904180
7354,500000,156731,97,0,Stable,Growth,656,150000,6731
7355,1642584,772844,92,0,Low Volume,Growth,600,492775,280069
7356,11035854,2269212,79,0,High Volume,Growth,638,2269212,0
7357,576108,204354,97,1,Stable,Declining,485,115221,89133
7358,500000,71056,90,0,Low Volume,Growth,572,71056,0
7359,597587,196160,98,0,Stable,Stable,597,119517,76643
7360,4068104,440631,88,0,Stable,Stable,576,440631,0
7361,4875930,248362,86,0,Stable,Growth,615,248362,0
7362,1315765,617343,93,0,Low Volume,Stable,549,263153,354190
7363,3424856,1026438,85,0,High Volume,Growth,650,1026438,0
7364,6029679,2816604,89,0,Low Volume,Growth,577,1205935,1610669
7365,8284337,1658725,87,0,High Volume,Declining,546,1656867,1858
7366,1628112,321558,86,0,Stable,Growth,606,321558,0
7367,500000,115147,90,0,Stable,Growth,637,115147,0
7368,1028176,378079,89,0,Stable,Growth,614,308452,69627
7369,1409234,429272,94,2,High Volume,Stable,541,281846,147426
7370,1611779,751749,91,0,Stable,Declining,514,322355,429394
7371,1706086,104836,86,1,Stable,Declining,480,104836,0
7372,4853039,1789258,85,1,Stable,Growth,559,970607,818651
7373,5496064,1091779,96,1,Stable,Declining,489,1091779,0
7374,1728321,226592,85,0,High Volume,Growth,639,226592,0
7375,4774443,1335307,97,0,Unstable,Growth,561,954888,380419
7376,2639577,731898,90,0,Low Volume,Growth,607,731898,0
7377,2087765,233109,89,1,Low Volume,Growth,560,233109,0
7378,4094828,576770,90,0,Stable,Declining,511,576770,0
7379,2100743,490889,91,1,Low Volume,Declining,462,420148,70741
7380,10285533,2406456,98,0,Stable,Growth,634,2406456,0
7381,627357,121018,93,0,Stable,Growth,617,121018,0
7382,1313050,153424,93,0,Low Volume,Declining,485,153424,0
7383,1791896,93122,78,0,Stable,Declining,480,93122,0
7384,2818068,1371288,88,0,High Volume,Growth,669,845420,525868
7385,5467699,2594831,83,0,Unstable,Growth,545,1093539,1501292
7386,1944433,520413,90,0,Stable,Declining,532,388886,131527
7387,635531,316350,89,0,Stable,Growth,635,190659,125691
7388,3890356,1373858,85,0,Stable,Declining,489,778071,595787
7389,3627184,293751,97,0,High Volume,Growth,707,293751,0
7390,500000,51487,97,0,Low Volume,Declining,499,51487,0
7391,1976734,913745,83,0,Stable,Growth,601,593020,320725
7392,555646,185321,91,2,Low Volume,Declining,422,111129,74192
7393,1165055,500313,93,0,Stable,Growth,644,349516,150797
7394,962946,437391,83,0,Low Volume,Declining,449,192589,244802
7395,3788239,953022,99,0,Low Volume,Growth,604,953022,0
7396,2177013,156389,80,0,Stable,Growth,570,156389,0
7397,708941,95513,91,0,High Volume,Declining,562,95513,0
7398,4009002,320549,92,0,Low Volume,Stable,532,320549,0
7399,629673,84964,85,0,High Volume,Declining,572,84964,0
7400,2582042,606108,93,0,Low Volume,Growth,581,516408,89700
7401,1033841,106681,85,1,Stable,Growth,551,106681,0
7402,1479860,185027,87,2,Stable,Growth,518,185027,0
7403,2968053,743853,90,1,High Volume,Declining,543,593610,150243
7404,3009124,611084,91,0,Stable,Growth,642,611084,0
7405,5778041,1504869,96,0,Stable,Stable,599,1155608,349261
7406,1856488,451363,92,0,High Volume,Stable,637,451363,0
7407,2533623,861470,92,0,Low Volume,Growth,580,506724,354746
7408,1396962,658996,89,0,High Volume,Declining,573,279392,379604
7409,2293505,226000,94,1,Stable,Stable,534,226000,0
7410,2818143,266785,96,0,Stable,Stable,579,266785,0
7411,1832794,794998,96,1,Unstable,Declining,427,366558,428440
7412,500000,138939,89,0,Low Volume,Growth,567,100000,38939
7413,2584847,1020710,88,1,Stable,Growth,574,516969,503741
7414,2654188,390006,87,0,Low Volume,Stable,517,390006,0
7415,1150677,486723,91,0,Low Volume,Declining,482,230135,256588
7416,709624,330494,92,0,High Volume,Stable,622,212887,117607
7417,6457180,2169402,87,1,Unstable,Declining,427,1291436,877966
7418,2937755,286859,85,0,Stable,Declining,485,286859,0
7419,1650742,747592,90,0,Stable,Declining,512,330148,417444
7420,798407,324648,93,0,Low Volume,Growth,601,239522,85126
7421,1027406,398526,95,0,High Volume,Growth,692,308221,90305
7422,5621293,373972,93,0,High Volume,Growth,677,373972,0
7423,2213597,906541,97,0,High Volume,Growth,702,885438,21103
7424,1276370,143053,97,0,Low Volume,Stable,550,143053,0
7425,2980946,447362,91,1,Stable,Growth,580,447362,0
7426,1033520,320092,95,1,Stable,Stable,532,206704,113388
7427,6587434,1114866,86,0,High Volume,Stable,603,1114866,0
7428,5851686,2034085,92,1,Low Volume,Growth,570,1170337,863748
7429,1365103,441791,83,0,Stable,Growth,616,409530,32261
7430,1199078,118310,81,2,Stable,Growth,509,118310,0
7431,500000,172603,93,0,High Volume,Stable,631,150000,22603
7432,606061,282291,91,0,Stable,Growth,628,181818,100473
7433,679032,83181,98,1,High Volume,Declining,573,83181,0
7434,2209225,704031,95,2,Low Volume,Growth,527,441845,262186
7435,1527302,311324,95,0,High Volume,Growth,687,311324,0
7436,675853,173576,82,0,High Volume,Growth,632,173576,0
7437,1583374,283662,95,0,Unstable,Growth,566,283662,0
7438,2970586,621918,80,0,High Volume,Growth,641,621918,0
7439,3024546,190578,99,0,High Volume,Growth,693,190578,0
7440,500000,245849,89,0,High Volume,Stable,609,150000,95849
7441,1789397,592577,92,0,Low Volume,Growth,613,536819,55758
7442,655614,180502,97,0,Low Volume,Stable,554,131122,49380
7443,4079084,908297,99,0,Unstable,Growth,573,815816,92481
7444,3712875,1086827,91,0,Stable,Growth,621,1086827,0
7445,966637,213673,88,0,High Volume,Growth,682,213673,0
7446,1074283,227703,85,0,High Volume,Growth,641,227703,0
7447,1370911,354759,94,1,Low Volume,Declining,468,274182,80577
7448,500000,87096,97,0,Unstable,Growth,577,87096,0
7449,2594163,339894,89,0,Unstable,Stable,520,339894,0
7450,1593948,478938,94,0,Low Volume,Growth,592,318789,160149
7451,4308671,1849473,88,0,Low Volume,Growth,572,861734,987739
7452,823462,97805,89,0,Stable,Declining,535,97805,0
7453,1208272,78212,96,0,Low Volume,Growth,590,78212,0
7454,594086,95687,88,0,High Volume,Stable,616,95687,0
7455,887858,435827,94,0,Stable,Growth,651,266357,169470
7456,770207,325752,93,0,Stable,Growth,612,231062,94690
7457,4398521,1399344,96,0,Stable,Stable,583,879704,519640
7458,1134146,530964,98,1,Stable,Stable,554,226829,304135
7459,2189843,548283,91,0,Stable,Stable,577,437968,110315
7460,1462107,720053,98,0,Stable,Stable,578,292421,427632
7461,718146,131662,95,0,Stable,Stable,565,131662,0
7462,1732991,274051,96,0,High Volume,Stable,649,274051,0
7463,3201989,1079460,89,1,Unstable,Stable,483,640397,439063
7464,754486,166115,97,0,Unstable,Growth,580,150897,15218
7465,3787778,1257029,98,1,High Volume,Stable,594,757555,499474
7466,1004724,188133,97,0,Stable,Stable,603,188133,0
7467,1347300,442000,99,0,Low Volume,Growth,632,404190,37810
7468,3031435,527730,93,0,Stable,Stable,590,527730,0
7469,1166188,85059,92,1,Stable,Declining,484,85059,0
7470,2043266,940845,92,0,Low Volume,Growth,614,612979,327866
7471,1541470,689719,86,1,Stable,Growth,565,308294,381425
7472,2198959,1070583,98,0,High Volume,Stable,659,659687,410896
7473,500000,186219,90,1,Stable,Growth,583,100000,86219
7474,500000,178612,93,0,High Volume,Stable,640,150000,28612
7475,3245479,978679,96,0,Stable,Stable,576,649095,329584
7476,4545940,484934,91,0,Low Volume,Stable,546,484934,0
7477,957050,129351,94,1,Stable,Growth,586,129351,0
7478,1631120,294028,85,0,High Volume,Declining,556,294028,0
7479,2509955,1130911,82,0,Low Volume,Growth,579,501991,628920
7480,3452379,441339,90,1,Stable,Growth,569,441339,0
7481,500000,232646,79,1,High Volume,Declining,478,100000,132646
7482,975951,278394,91,0,Stable,Growth,641,278394,0
7483,1519568,565289,92,1,Stable,Growth,572,303913,261376
7484,3479893,346632,93,1,Stable,Stable,519,346632,0
7485,14632335,2503082,89,0,Stable,Growth,605,2503082,0
7486,1652162,795241,96,1,Stable,Growth,603,495648,299593
7487,643333,109217,83,0,Low Volume,Stable,513,109217,0
7488,2735472,501781,86,0,High Volume,Growth,659,501781,0
7489,5704675,792487,89,0,High Volume,Growth,669,792487,0
7490,2161713,233645,89,1,Low Volume,Growth,529,233645,0
7491,959993,148766,99,0,High Volume,Stable,637,148766,0
7492,4266887,1446676,82,2,Unstable,Growth,457,853377,593299
7493,3371393,859420,84,0,Stable,Growth,621,859420,0
7494,872515,261048,96,0,Low Volume,Growth,601,261048,0
7495,2690239,282648,94,1,Stable,Stable,537,282648,0
7496,4403069,1809452,90,1,Low Volume,Growth,563,880613,928839
7497,5103882,2056061,88,0,Stable,Growth,598,1020776,1035285
7498,1880110,112272,88,0,Stable,Declining,501,112272,0
7499,1488883,331398,87,0,Stable,Growth,592,297776,33622
7500,5292594,428418,86,0,Unstable,Growth,538,428418,0
7501,753038,306070,88,0,High Volume,Growth,684,225911,80159
7502,2816100,1075106,91,0,High Volume,Growth,693,844830,230276
7503,662634,302091,97,0,Stable,Growth,661,198790,103301
7504,4649643,727119,90,0,Stable,Growth,622,727119,0
7505,1612931,411835,92,0,Stable,Growth,606,411835,0
7506,5470423,727673,95,1,High Volume,Growth,634,727673,0
7507,2937679,637640,95,1,Stable,Growth,580,587535,50105
7508,745212,212392,94,0,Stable,Stable,564,149042,63350
7509,6197783,458629,96,0,High Volume,Growth,686,458629,0
7510,6858479,2549240,93,2,Unstable,Stable,447,1371695,1177545
7511,4016130,1182678,93,0,Low Volume,Growth,593,803226,379452
7512,1078120,456079,87,0,Low Volume,Declining,483,215624,240455
7513,1552208,267447,93,0,Stable,Stable,566,267447,0
7514,2227392,1016792,97,1,High Volume,Declining,555,445478,571314
7515,1129213,563943,93,1,Stable,Stable,542,225842,338101
7516,7678058,3560195,98,0,Low Volume,Stable,581,1535611,2024584
7517,2225431,890287,90,1,High Volume,Stable,571,445086,445201
7518,500000,207783,98,0,Stable,Stable,574,100000,107783
7519,2601203,801652,91,0,Unstable,Stable,496,520240,281412
7520,1500748,203455,95,0,Low Volume,Growth,623,203455,0
7521,1867402,662308,86,2,Stable,Growth,537,373480,288828
7522,1476381,547352,90,0,Stable,Declining,533,295276,252076
7523,3781522,1865891,92,0,Stable,Growth,646,1134456,731435
7524,4856120,1425687,81,0,Low Volume,Stable,525,971224,454463
7525,2486639,427990,92,0,Stable,Declining,535,427990,0
7526,1511406,540558,99,0,Low Volume,Growth,636,453421,87137
7527,1918262,941328,87,0,High Volume,Stable,603,575478,365850
7528,2014093,261321,98,0,Stable,Declining,553,261321,0
7529,1043463,205248,91,0,Stable,Growth,621,205248,0
7530,3150724,925829,93,1,High Volume,Stable,588,630144,295685
7531,2864871,362683,97,0,High Volume,Growth,708,362683,0
7532,6799455,407962,97,0,Stable,Growth,624,407962,0
7533,5412815,1091453,80,0,High Volume,Stable,592,1082563,8890
7534,1145624,503407,92,0,High Volume,Declining,580,229124,274283
7535,3821825,265849,99,0,Stable,Declining,537,265849,0
7536,926563,225172,79,0,Stable,Stable,547,185312,39860
7537,3459884,1359701,92,0,High Volume,Stable,617,1037965,321736
7538,1311535,628136,91,0,Unstable,Stable,533,262307,365829
7539,874491,431530,88,0,Stable,Growth,627,262347,169183
7540,2480663,595077,93,0,Stable,Growth,638,595077,0
7541,500000,238836,98,0,High Volume,Stable,639,150000,88836
7542,500000,32969,93,0,Stable,Growth,640,32969,0
7543,1720295,663453,95,0,Stable,Declining,550,344059,319394
7544,2117938,718480,94,0,Stable,Growth,629,635381,83099
7545,1475555,239460,83,0,High Volume,Growth,636,239460,0
7546,560425,155963,97,0,High Volume,Declining,601,155963,0
7547,1030636,111617,97,1,Stable,Growth,616,111617,0
7548,2711378,1199022,89,0,High Volume,Growth,659,813413,385609
7549,3157924,666493,86,0,High Volume,Growth,655,666493,0
7550,1957192,649240,92,0,Low Volume,Growth,610,587157,62083
7551,5002593,607562,95,0,High Volume,Declining,591,607562,0
7552,2724833,389036,99,1,High Volume,Stable,592,389036,0
7553,1090379,541243,91,0,High Volume,Stable,612,327113,214130
7554,1584213,616083,80,1,Unstable,Stable,456,316842,299241
7555,645453,311681,88,0,High Volume,Growth,650,193635,118046
7556,1818439,333016,94,1,Stable,Stable,537,333016,0
7557,4826733,598772,97,0,Stable,Growth,622,598772,0
7558,3430553,948139,94,0,Unstable,Growth,576,686110,262029
7559,6086644,1659224,95,0,Low Volume,Growth,610,1659224,0
7560,1556098,200310,86,0,High Volume,Declining,563,200310,0
7561,5820402,2211455,92,0,High Volume,Growth,673,1746120,465335
7562,1698671,361477,96,0,Stable,Growth,655,361477,0
7563,6435036,861422,94,0,High Volume,Declining,581,861422,0
7564,1948391,388495,87,1,Low Volume,Growth,548,388495,0
7565,3491301,1060121,93,0,Low Volume,Growth,581,698260,361861
7566,6453221,2432296,99,1,Unstable,Growth,562,1290644,1141652
7567,1698503,453247,92,0,Stable,Declining,545,339700,113547
7568,2361272,676546,84,0,Stable,Growth,582,472254,204292
7569,5559900,625631,89,0,Stable,Growth,606,625631,0
7570,1782625,822879,94,0,High Volume,Growth,692,534787,288092
7571,689200,322495,93,0,Stable,Growth,628,206760,115735
7572,11011003,3936896,88,0,Unstable,Growth,541,2202200,1734696
7573,1361624,78885,90,0,Stable,Growth,606,78885,0
7574,2251270,656658,91,0,High Volume,Declining,587,450254,206404
7575,4999284,1665504,98,0,Low Volume,Stable,583,999856,665648
7576,1218590,606364,98,0,High Volume,Declining,593,243718,362646
7577,885321,441094,89,0,Stable,Growth,599,177064,264030
7578,2428999,1058862,87,1,Low Volume,Declining,431,485799,573063
7579,500000,39362,88,0,High Volume,Growth,655,39362,0
7580,1574857,754316,82,0,High Volume,Declining,537,314971,439345
7581,2412155,785633,89,0,High Volume,Stable,604,723646,61987
7582,1597641,655670,91,0,Low Volume,Growth,594,319528,336142
7583,576793,134529,93,0,High Volume,Declining,578,115358,19171
7584,7098133,1375982,91,0,Stable,Growth,617,1375982,0
7585,2153986,556719,97,1,High Volume,Stable,611,556719,0
7586,6230217,723288,92,0,Stable,Growth,635,723288,0
7587,1610364,339271,91,0,High Volume,Stable,642,339271,0
7588,980669,427501,93,0,Low Volume,Growth,609,294200,133301
7589,2459195,164957,96,0,Stable,Growth,637,164957,0
7590,1668391,196695,96,1,High Volume,Growth,629,196695,0
7591,772812,82152,94,0,Unstable,Declining,457,82152,0
7592,6425772,1486821,97,1,Low Volume,Declining,464,1285154,201667
7593,1205233,600982,91,0,High Volume,Stable,628,361569,239413
7594,500000,64006,95,1,High Volume,Declining,557,64006,0
7595,5737493,662492,96,0,Stable,Growth,640,662492,0
7596,1324521,611631,97,1,Stable,Growth,605,397356,214275
7597,1219243,544907,91,0,High Volume,Stable,640,365772,179135
7598,500000,32254,95,0,Low Volume,Stable,571,32254,0
7599,7982428,3099319,86,0,High Volume,Growth,665,2394728,704591
7600,706738,243796,89,2,Stable,Declining,451,141347,102449
7601,2077674,821686,93,0,Stable,Growth,615,623302,198384
7602,4114781,1121385,85,0,Low Volume,Declining,456,822956,298429
7603,2778366,1378405,88,0,Low Volume,Growth,580,555673,822732
7604,1890358,131817,92,0,High Volume,Growth,682,131817,0
7605,508219,79011,88,0,High Volume,Stable,595,79011,0
7606,1037392,236988,93,0,Stable,Growth,620,236988,0
7607,2304191,581578,92,0,Stable,Declining,521,460838,120740
7608,1056277,490762,95,0,Low Volume,Stable,566,211255,279507
7609,2333051,704586,89,1,High Volume,Stable,574,466610,237976
7610,3420833,240484,82,0,Stable,Stable,541,240484,0
7611,4282306,1000083,94,0,High Volume,Growth,666,1000083,0
7612,743450,176510,93,1,Low Volume,Declining,462,148690,27820
7613,11493783,5568404,91,2,Stable,Growth,533,2298756,3269648
7614,3663698,1171060,91,0,Stable,Growth,626,1099109,71951
7615,1980042,665379,90,0,Stable,Declining,513,396008,269371
7616,4740387,1758512,85,0,Stable,Growth,620,1422116,336396
7617,13155181,5216262,92,0,Stable,Growth,606,3946554,1269708
7618,627202,210597,96,0,Low Volume,Declining,513,125440,85157
7619,1655792,259525,85,1,High Volume,Declining,520,259525,0
7620,500000,221660,85,0,Stable,Growth,588,100000,121660
7621,2313151,877734,95,0,Stable,Stable,590,462630,415104
7622,2655956,1019467,91,0,Stable,Stable,556,531191,488276
7623,1921603,957824,88,0,Low Volume,Growth,595,384320,573504
7624,1174524,482890,93,0,Low Volume,Declining,494,234904,247986
7625,500000,211559,97,0,High Volume,Stable,657,150000,61559
7626,2673307,1278195,94,1,Low Volume,Growth,557,534661,743534
7627,6352428,749652,96,0,High Volume,Declining,607,749652,0
7628,1235746,338566,92,0,Stable,Growth,625,338566,0
7629,2819437,877564,87,0,Stable,Stable,557,563887,313677
7630,565511,112070,99,0,High Volume,Stable,646,112070,0
7631,2858394,1222625,88,0,Stable,Declining,525,571678,650947
7632,1447421,568965,88,0,Unstable,Declining,444,289484,279481
7633,1077405,403378,92,0,High Volume,Declining,584,215481,187897
7634,1079177,538204,94,0,High Volume,Stable,638,323753,214451
7635,1447156,241272,84,0,Low Volume,Stable,522,241272,0
7636,2692408,1025688,96,0,Stable,Growth,656,807722,217966
7637,694029,206912,95,1,Stable,Growth,603,206912,0
7638,1443105,275410,91,0,Stable,Growth,639,275410,0
7639,1918056,234509,90,1,High Volume,Stable,591,234509,0
7640,823047,372962,95,0,High Volume,Stable,655,246914,126048
7641,8346327,2653756,83,0,High Volume,Growth,669,2503898,149858
7642,1001694,421934,91,0,High Volume,Growth,664,300508,121426
7643,1160603,342848,83,0,High Volume,Growth,652,342848,0
7644,906507,135060,94,0,Low Volume,Declining,507,135060,0
7645,8358454,1687547,90,1,Stable,Growth,580,1671690,15857
7646,3085808,684100,91,0,High Volume,Growth,683,684100,0
7647,937270,457220,97,0,Stable,Growth,627,281181,176039
7648,4804124,252385,96,0,Unstable,Growth,590,252385,0
7649,2328090,1149028,95,1,High Volume,Declining,541,465618,683410
7650,2435841,1196504,90,0,Low Volume,Growth,609,730752,465752
7651,1505173,749979,95,0,Low Volume,Growth,602,451551,298428
7652,1088670,287915,90,1,Stable,Growth,560,217734,70181
7653,2597897,1256639,98,1,Stable,Stable,553,519579,737060
7654,1281998,292321,98,1,Stable,Growth,604,292321,0
7655,8481556,524436,88,0,Stable,Growth,631,524436,0
7656,718246,108424,95,1,Low Volume,Declining,476,108424,0
7657,6776189,3221287,95,0,Low Volume,Growth,606,2032856,1188431
7658,1813819,101926,81,1,Stable,Declining,457,101926,0
7659,2518738,744784,98,0,Low Volume,Growth,625,744784,0
7660,3861345,324433,96,0,Low Volume,Growth,618,324433,0
7661,1197565,214219,93,0,Stable,Stable,593,214219,0
7662,3958591,354855,83,0,Stable,Growth,591,354855,0
7663,500000,218394,92,1,Stable,Growth,581,100000,118394
7664,1114602,352194,97,0,High Volume,Stable,657,334380,17814
7665,946712,431651,95,0,Stable,Growth,655,284013,147638
7666,727373,261679,83,0,Stable,Declining,497,145474,116205
7667,1669502,812986,91,0,High Volume,Growth,693,500850,312136
7668,2699562,754379,83,0,High Volume,Stable,593,539912,214467
7669,3478557,1173734,97,1,High Volume,Growth,663,1043567,130167
7670,2404137,743693,99,0,Low Volume,Growth,597,480827,262866
7671,1164084,311878,94,1,High Volume,Declining,534,232816,79062
7672,2663664,1147191,89,0,Stable,Stable,570,532732,614459
7673,2190036,744692,97,0,High Volume,Declining,593,438007,306685
7674,4192656,1721465,92,0,High Volume,Growth,693,1257796,463669
7675,3691522,1490872,96,0,Low Volume,Growth,616,1107456,383416
7676,2031695,276250,93,0,Low Volume,Growth,594,276250,0
7677,967236,331350,98,0,Stable,Stable,605,290170,41180
7678,1176012,164455,91,0,Low Volume,Growth,609,164455,0
7679,1277184,399113,92,1,Low Volume,Growth,551,255436,143677
7680,1540761,546732,96,1,High Volume,Growth,666,462228,84504
7681,2456972,1225429,96,0,Stable,Stable,591,491394,734035
7682,3513557,223968,96,0,Low Volume,Growth,627,223968,0
7683,1903310,173314,87,0,Stable,Growth,611,173314,0
7684,2008502,170044,94,0,Low Volume,Growth,614,170044,0
7685,2223616,509792,94,0,Stable,Growth,638,509792,0
7686,1312279,550783,94,0,High Volume,Growth,690,393683,157100
7687,945705,406488,97,0,Stable,Stable,603,283711,122777
7688,500000,190820,84,0,Stable,Growth,617,150000,40820
7689,1136974,515726,86,1,Stable,Growth,585,227394,288332
7690,2895060,565368,97,0,High Volume,Stable,652,565368,0
7691,1129935,101321,97,0,High Volume,Growth,698,101321,0
7692,1639258,124860,97,0,Low Volume,Growth,628,124860,0
7693,2879551,1248169,89,0,Stable,Growth,622,863865,384304
7694,3007295,1138852,94,0,High Volume,Growth,667,902188,236664
7695,835991,304616,98,0,High Volume,Growth,692,250797,53819
7696,4402343,893034,91,0,High Volume,Growth,667,893034,0
7697,4885978,1079593,97,0,High Volume,Stable,637,1079593,0
7698,803008,386368,90,0,Unstable,Growth,573,160601,225767
7699,1025746,80739,88,0,Low Volume,Growth,564,80739,0
7700,5141588,2047274,95,0,High Volume,Growth,683,1542476,504798
7701,1762982,333794,97,0,Low Volume,Growth,593,333794,0
7702,500000,33787,90,0,Stable,Declining,516,33787,0
7703,647099,248587,85,1,High Volume,Growth,633,194129,54458
7704,1624165,323063,97,0,Low Volume,Growth,604,323063,0
7705,781965,293211,99,0,High Volume,Growth,687,234589,58622
7706,1424400,524812,76,0,Low Volume,Growth,543,284880,239932
7707,2034818,591428,98,0,Low Volume,Stable,573,406963,184465
7708,6387182,2553710,93,0,Low Volume,Stable,567,1277436,1276274
7709,1571650,489517,92,0,Low Volume,Stable,552,314330,175187
7710,4676373,837008,97,0,Unstable,Growth,578,837008,0
7711,6218306,2365144,97,1,Low Volume,Declining,473,1243661,1121483
7712,6245975,1968187,91,1,Stable,Growth,589,1249195,718992
7713,2490026,138762,95,1,High Volume,Growth,635,138762,0
7714,500000,227870,89,0,High Volume,Stable,609,150000,77870
7715,2866665,847213,96,0,Low Volume,Growth,610,847213,0
7716,4586923,2022293,85,1,Unstable,Growth,510,917384,1104909
7717,1858251,831069,99,0,Low Volume,Stable,580,371650,459419
7718,8005722,2003312,91,0,Stable,Growth,637,2003312,0
7719,3944634,1098371,91,0,High Volume,Growth,690,1098371,0
7720,3123981,740663,83,0,Unstable,Stable,488,624796,115867
7721,4728434,1192731,88,1,Stable,Growth,577,945686,247045
7722,2588776,1172240,93,0,Stable,Growth,640,776632,395608
7723,500000,202332,98,0,Low Volume,Stable,569,100000,102332
7724,1329999,142226,85,0,Unstable,Stable,476,142226,0
7725,5166647,1677293,98,0,Stable,Growth,636,1549994,127299
7726,1039164,517668,94,0,Stable,Growth,614,311749,205919
7727,1658165,527293,94,0,High Volume,Stable,650,497449,29844
7728,859521,346939,99,1,Unstable,Growth,562,171904,175035
7729,8261676,3272265,95,0,High Volume,Stable,626,2478502,793763
7730,7611676,1580510,92,0,Unstable,Growth,572,1522335,58175
7731,977648,212474,93,0,High Volume,Growth,672,212474,0
7732,2230728,838384,80,0,Unstable,Growth,519,446145,392239
7733,1150382,316347,83,3,Stable,Growth,499,230076,86271
7734,3242826,994759,96,0,Stable,Growth,655,972847,21912
7735,2980932,1105352,98,1,High Volume,Growth,645,894279,211073
7736,3795643,1517911,92,1,Stable,Growth,605,1138692,379219
7737,2585772,445225,94,0,Stable,Growth,622,445225,0
7738,20755565,2408833,90,0,High Volume,Stable,601,2408833,0
7739,871230,157961,93,0,Stable,Growth,639,157961,0
7740,504598,140476,90,0,Low Volume,Growth,579,100919,39557
7741,1447760,295290,96,0,High Volume,Growth,673,295290,0
7742,565581,172934,88,0,Stable,Growth,615,169674,3260
7743,600808,44496,88,0,High Volume,Growth,662,44496,0
7744,889975,248648,83,2,Low Volume,Declining,378,177995,70653
7745,948132,204411,95,0,High Volume,Stable,641,204411,0
7746,923850,268471,83,0,High Volume,Growth,656,268471,0
7747,3001357,720746,87,0,Low Volume,Stable,520,600271,120475
7748,1322519,235278,96,1,Stable,Growth,594,235278,0
7749,1717514,784644,87,1,High Volume,Declining,515,343502,441142
7750,4054696,539859,94,0,Stable,Growth,623,539859,0
7751,1074044,383020,90,0,Low Volume,Declining,489,214808,168212
7752,1604565,747872,80,0,Stable,Stable,535,320913,426959
7753,2656734,776833,89,0,Stable,Declining,516,531346,245487
7754,500000,222192,88,0,Stable,Growth,620,150000,72192
7755,500000,53092,98,2,Unstable,Declining,405,53092,0
7756,2615312,711901,92,1,Stable,Growth,592,523062,188839
7757,2939093,751413,90,2,Stable,Declining,432,587818,163595
7758,10338404,554691,99,0,Low Volume,Growth,601,554691,0
7759,2250079,561318,97,1,High Volume,Stable,597,450015,111303
7760,3820118,825388,92,0,High Volume,Stable,639,825388,0
7761,1695727,595894,82,1,High Volume,Growth,607,508718,87176
7762,2514996,1187703,98,0,Stable,Growth,653,754498,433205
7763,7525482,666803,90,0,Stable,Growth,602,666803,0
7764,500000,98682,99,0,Low Volume,Growth,603,98682,0
7765,2760419,689633,89,0,Stable,Stable,561,552083,137550
7766,10945833,2789364,92,0,High Volume,Declining,562,2189166,600198
7767,2484613,990527,92,1,High Volume,Stable,568,496922,493605
7768,7425706,1852922,93,0,Low Volume,Stable,557,1485141,367781
7769,1198559,74577,98,0,High Volume,Stable,629,74577,0
7770,1932571,714176,97,1,Stable,Stable,557,386514,327662
7771,2036656,912775,89,2,High Volume,Declining,467,407331,505444
7772,500000,140629,86,1,High Volume,Growth,631,140629,0
7773,778760,242583,97,0,High Volume,Growth,678,233628,8955
7774,824473,101675,99,1,Unstable,Growth,551,101675,0
7775,3827234,571370,91,0,High Volume,Stable,617,571370,0
7776,3983704,620767,79,2,High Volume,Growth,574,620767,0
7777,2569519,626536,92,0,Stable,Declining,516,513903,112633
7778,3833475,1792783,97,1,Stable,Growth,589,766695,1026088
7779,1738756,495203,90,1,Unstable,Stable,476,347751,147452
7780,5186374,707649,83,1,High Volume,Growth,601,707649,0
7781,1996749,338927,91,1,Low Volume,Growth,544,338927,0
7782,2076701,462703,89,2,Stable,Growth,527,415340,47363
7783,1603222,529811,90,2,Stable,Growth,554,320644,209167
7784,3428250,850257,96,0,High Volume,Stable,640,850257,0
7785,1415567,320768,92,1,High Volume,Growth,636,320768,0
7786,4330290,1316962,94,0,High Volume,Declining,589,866058,450904
7787,801532,127304,83,1,Stable,Growth,545,127304,0
7788,823128,70383,91,1,High Volume,Stable,575,70383,0
7789,3436422,209575,87,0,Unstable,Growth,561,209575,0
7790,1847169,301212,93,0,Stable,Growth,643,301212,0
7791,1379024,125790,90,0,Stable,Growth,616,125790,0
7792,4041176,813704,79,0,Stable,Growth,590,808235,5469
7793,1219792,485258,93,0,High Volume,Growth,680,365937,119321
7794,1689324,628990,95,1,Stable,Declining,484,337864,291126
7795,6073116,1973261,88,1,High Volume,Growth,619,1821934,151327
7796,6792393,2945352,95,0,Unstable,Growth,591,1358478,1586874
7797,6975528,1234183,85,0,Stable,Growth,590,1234183,0
7798,1582157,709240,84,0,High Volume,Declining,543,316431,392809
7799,5307133,1218824,92,0,Stable,Growth,606,1218824,0
7800,928047,213824,86,0,High Volume,Growth,653,213824,0
7801,959798,223065,88,0,Low Volume,Declining,497,191959,31106
7802,500000,47071,98,0,Unstable,Growth,600,47071,0
7803,7559341,3696296,99,1,Unstable,Declining,453,1511868,2184428
7804,993328,111579,93,1,Stable,Stable,523,111579,0
7805,1791876,364465,99,0,Low Volume,Growth,615,364465,0
7806,957174,185390,93,0,High Volume,Growth,669,185390,0
7807,3457762,289089,92,0,High Volume,Stable,642,289089,0
7808,1468120,173997,93,2,Low Volume,Growth,509,173997,0
7809,698120,48998,97,1,Stable,Stable,538,48998,0
7810,2823055,512616,94,1,Unstable,Growth,527,512616,0
7811,629711,277070,94,0,Unstable,Declining,482,125942,151128
7812,1014671,205724,85,1,Stable,Growth,555,202934,2790
7813,500000,52831,96,0,Stable,Growth,618,52831,0
7814,634653,216139,93,0,Stable,Growth,625,190395,25744
7815,2287164,1140084,93,0,Stable,Declining,533,457432,682652
7816,500000,77273,95,0,High Volume,Growth,690,77273,0
7817,606272,106587,95,0,Stable,Declining,548,106587,0
7818,1979005,964431,94,0,High Volume,Growth,663,593701,370730
7819,1283517,167434,98,1,Stable,Growth,599,167434,0
7820,9758305,2732778,90,1,High Volume,Growth,640,2732778,0
7821,8598663,1357243,89,1,Stable,Stable,528,1357243,0
7822,990200,464957,96,0,Stable,Growth,639,297060,167897
7823,3096274,1522390,94,1,Stable,Declining,503,619254,903136
7824,3610750,1504289,88,0,Unstable,Growth,539,722150,782139
7825,1229376,235613,89,0,Stable,Declining,498,235613,0
7826,599329,138786,80,0,Low Volume,Growth,546,119865,18921
7827,1963347,312246,93,1,Stable,Declining,479,312246,0
7828,1726701,778468,95,0,Low Volume,Stable,544,345340,433128
7829,1399168,645788,92,2,Stable,Stable,491,279833,365955
7830,2824533,673628,94,0,High Volume,Stable,612,673628,0
7831,1087526,375675,97,0,Unstable,Declining,495,217505,158170
7832,788906,98218,91,0,Stable,Growth,640,98218,0
7833,2163562,531633,96,0,High Volume,Growth,706,531633,0
7834,2700037,902284,97,0,Unstable,Growth,570,540007,362277
7835,773502,172825,97,0,High Volume,Declining,605,172825,0
7836,4166023,878697,88,0,Stable,Growth,606,878697,0
7837,500000,25225,94,0,Low Volume,Declining,495,25225,0
7838,1248570,514326,92,0,Low Volume,Growth,587,249714,264612
7839,1612979,726166,91,0,High Volume,Growth,655,483893,242273
7840,1191854,579549,89,1,High Volume,Stable,594,238370,341179
7841,1261676,471453,86,0,Low Volume,Declining,468,252335,219118
7842,8858248,2630515,96,1,Stable,Stable,561,1771649,858866
7843,1003789,171827,84,0,Stable,Growth,606,171827,0
7844,13977751,6984469,96,0,Stable,Stable,590,2795550,4188919
7845,2812829,887135,90,1,Low Volume,Stable,487,562565,324570
7846,2134289,760915,94,0,High Volume,Growth,688,640286,120629
7847,2902237,1036339,90,0,High Volume,Stable,603,870671,165668
7848,15005723,6457913,95,0,Unstable,Declining,478,3001144,3456769
7849,895489,48672,86,0,High Volume,Growth,650,48672,0
7850,809090,120644,95,0,Unstable,Declining,495,120644,0
7851,1083933,378824,91,1,Unstable,Growth,533,216786,162038
7852,2034406,921211,99,0,Low Volume,Stable,560,406881,514330
7853,500000,179201,89,0,Stable,Growth,616,150000,29201
7854,2018512,476512,89,2,High Volume,Stable,553,403702,72810
7855,7685436,1634692,83,0,Stable,Stable,550,1537087,97605
7856,2238073,855115,93,0,Low Volume,Growth,590,447614,407501
7857,1568847,601742,93,0,Low Volume,Stable,531,313769,287973
7858,1209203,390786,86,0,High Volume,Growth,669,362760,28026
7859,4068599,737068,93,1,Stable,Growth,573,737068,0
7860,1024109,477562,85,0,Stable,Stable,566,204821,272741
7861,8685076,2591157,94,0,Stable,Stable,573,1737015,854142
7862,9310821,3777601,86,0,Low Volume,Growth,585,1862164,1915437
7863,2434862,356558,96,0,Stable,Declining,544,356558,0
7864,1964578,402382,82,0,High Volume,Growth,648,402382,0
7865,4522285,2005908,95,0,High Volume,Growth,668,1356685,649223
7866,4760384,345357,97,0,High Volume,Growth,675,345357,0
7867,1040494,291902,89,0,High Volume,Growth,684,291902,0
7868,1301146,347103,84,0,Stable,Growth,590,260229,86874
7869,688398,267135,92,1,High Volume,Declining,524,137679,129456
7870,2750386,486412,91,0,High Volume,Growth,681,486412,0
7871,3379716,502158,83,0,High Volume,Growth,645,502158,0
7872,673376,314305,83,1,Stable,Stable,507,134675,179630
7873,1377583,423289,93,1,Unstable,Stable,460,275516,147773
7874,674817,65532,98,1,Unstable,Stable,505,65532,0
7875,966040,132218,82,0,High Volume,Growth,640,132218,0
7876,3081151,1538948,87,2,Low Volume,Stable,471,616230,922718
7877,1102636,152190,94,0,Stable,Declining,513,152190,0
7878,1558663,506120,87,0,Stable,Growth,604,467598,38522
7879,539367,128940,97,0,Stable,Stable,602,128940,0
7880,2302698,1032805,93,0,Unstable,Declining,487,460539,572266
7881,1913762,746034,98,1,Stable,Declining,509,382752,363282
7882,1106633,352604,90,1,High Volume,Growth,621,331989,20615
7883,1704511,93463,88,0,Low Volume,Declining,489,93463,0
7884,2290397,1021306,93,0,Stable,Stable,594,458079,563227
7885,1033132,258387,90,0,High Volume,Stable,611,258387,0
7886,608645,285582,88,0,Stable,Growth,626,182593,102989
7887,8406027,2294783,85,0,Stable,Stable,560,1681205,613578
7888,1194672,432950,83,1,High Volume,Growth,611,358401,74549
7889,1835068,148974,91,0,Unstable,Stable,505,148974,0
7890,4451144,1715107,92,0,Low Volume,Stable,562,890228,824879
7891,33372546,6744532,92,0,Stable,Growth,645,6744532,0
7892,732641,152471,98,0,High Volume,Growth,701,152471,0
7893,2841554,293803,92,1,Stable,Growth,599,293803,0
7894,1125748,130683,85,0,Stable,Stable,575,130683,0
7895,1288472,172129,83,1,Low Volume,Stable,477,172129,0
7896,1114404,220310,89,0,High Volume,Stable,621,220310,0
7897,805707,363685,92,0,Stable,Declining,540,161141,202544
7898,1918333,413817,96,1,Stable,Stable,548,383666,30151
7899,609502,229150,92,0,Stable,Stable,561,121900,107250
7900,4228873,368912,95,0,High Volume,Growth,680,368912,0
7901,2071953,654726,87,0,Stable,Stable,564,414390,240336
7902,2779962,741836,87,1,Stable,Declining,466,555992,185844
7903,1365524,669217,99,0,Unstable,Declining,496,273104,396113
7904,1478054,636736,99,0,Stable,Growth,654,443416,193320
7905,2495628,635570,95,0,Stable,Stable,574,499125,136445
7906,781335,311608,95,0,Stable,Stable,581,156267,155341
7907,1488989,203794,96,0,High Volume,Stable,637,203794,0
7908,996804,302083,96,1,High Volume,Growth,663,299041,3042
7909,972422,81274,95,0,Low Volume,Declining,508,81274,0
7910,500000,103320,99,1,Stable,Growth,602,103320,0
7911,5788949,877825,93,0,Low Volume,Declining,498,877825,0
7912,1144833,427606,99,0,Unstable,Stable,542,228966,198640
7913,5028845,1360508,99,0,High Volume,Growth,705,1360508,0
7914,4662367,1808913,89,0,High Volume,Growth,668,1398710,410203
7915,708709,199773,96,0,Stable,Growth,637,199773,0
7916,830075,73809,85,0,High Volume,Growth,666,73809,0
7917,15377291,5857448,88,1,Low Volume,Declining,452,3075458,2781990
7918,8046444,3419362,94,0,High Volume,Stable,634,2413933,1005429
7919,1933389,882764,92,1,Low Volume,Declining,469,386677,496087
7920,2436074,748840,93,0,Stable,Growth,620,730822,18018
7921,1196993,465766,93,0,High Volume,Growth,677,359097,106669
7922,2802107,1088394,96,0,Stable,Growth,634,840632,247762
7923,1117109,134151,99,0,Stable,Declining,565,134151,0
7924,500000,61950,97,0,Low Volume,Growth,612,61950,0
7925,688834,56414,91,1,Stable,Stable,522,56414,0
7926,2016501,391123,96,0,Unstable,Growth,575,391123,0
7927,802226,211049,86,1,Stable,Growth,552,160445,50604
7928,1878864,937655,98,0,Low Volume,Stable,544,375772,561883
7929,839256,204734,98,0,High Volume,Growth,699,204734,0
7930,1060358,399553,87,0,Low Volume,Growth,585,212071,187482
7931,3923647,1420473,95,0,Stable,Growth,627,1177094,243379
7932,2416871,343236,93,0,Stable,Stable,597,343236,0
7933,1967489,150175,93,0,Stable,Stable,597,150175,0
7934,4005469,1184429,90,1,Stable,Stable,521,801093,383336
7935,2912397,1063425,96,0,Unstable,Growth,577,582479,480946
7936,6307504,3148790,95,0,Stable,Growth,620,1892251,1256539
7937,1372456,290103,90,0,High Volume,Growth,667,290103,0
7938,1406046,637451,83,0,Low Volume,Growth,550,281209,356242
7939,700194,155352,93,0,Stable,Stable,567,140038,15314
7940,1406782,506772,89,0,Stable,Declining,529,281356,225416
7941,4290080,1369453,93,0,Low Volume,Growth,579,858016,511437
7942,5609600,414215,99,0,Stable,Growth,637,414215,0
7943,4274784,364531,95,0,Stable,Growth,636,364531,0
7944,500000,29672,89,0,Unstable,Declining,440,29672,0
7945,4716210,1022830,99,0,High Volume,Growth,697,1022830,0
7946,500000,192805,95,0,High Volume,Stable,643,150000,42805
7947,4067316,519559,95,0,Low Volume,Growth,604,519559,0
7948,1477368,476649,92,0,Low Volume,Stable,530,295473,181176
7949,3478204,625981,88,0,High Volume,Growth,670,625981,0
7950,682857,279047,89,0,High Volume,Declining,579,136571,142476
7951,5060289,2071066,89,0,Low Volume,Growth,584,1012057,1059009
7952,614166,245013,96,2,Stable,Stable,509,122833,122180
7953,1161515,332397,91,0,Low Volume,Stable,563,232303,100094
7954,892270,158873,89,0,Unstable,Stable,523,158873,0
7955,500000,207125,89,1,High Volume,Declining,524,100000,107125
7956,2138515,286016,92,0,Unstable,Stable,516,286016,0
7957,8409489,1517003,92,0,Low Volume,Growth,581,1517003,0
7958,16743559,2223151,95,1,Low Volume,Stable,522,2223151,0
7959,2143016,757330,89,0,Stable,Stable,548,428603,328727
7960,4844454,1738220,91,0,Stable,Growth,617,1453336,284884
7961,2387305,820348,91,0,Stable,Growth,613,716191,104157
7962,2955288,700464,87,0,Stable,Declining,501,591057,109407
7963,1507979,143374,92,0,Unstable,Stable,521,143374,0
7964,2317644,1066177,95,1,Stable,Growth,601,695293,370884
7965,3047960,848793,88,1,High Volume,Stable,576,609592,239201
7966,1248224,291008,88,1,Stable,Stable,511,249644,41364
7967,1863570,586971,97,0,High Volume,Growth,690,559071,27900
7968,1892210,258770,91,0,Unstable,Growth,576,258770,0
7969,3840537,421103,87,1,Stable,Declining,476,421103,0
7970,845070,196467,92,0,Unstable,Stable,496,169014,27453
7971,1902665,289679,94,1,High Volume,Growth,645,289679,0
7972,9153111,1463863,96,0,Stable,Growth,658,1463863,0
7973,5031598,2272421,90,0,High Volume,Growth,678,1509479,762942
7974,5834757,1685321,96,1,Stable,Growth,588,1166951,518370
7975,2021894,540980,96,0,Stable,Growth,625,540980,0
7976,2563279,923462,96,0,Stable,Declining,547,512655,410807
7977,4420613,2113922,82,1,Stable,Growth,550,884122,1229800
7978,6908095,694190,96,1,High Volume,Growth,645,694190,0
7979,500000,212545,87,1,High Volume,Growth,625,150000,62545
7980,692212,216530,86,0,Low Volume,Growth,568,138442,78088
7981,5652199,654380,96,0,Low Volume,Growth,596,654380,0
7982,1588798,291890,91,0,Low Volume,Stable,554,291890,0
7983,1158485,309388,84,0,High Volume,Growth,643,309388,0
7984,726992,262466,94,0,High Volume,Growth,684,218097,44369
7985,1271855,202445,98,0,High Volume,Growth,697,202445,0
7986,645709,187705,91,0,Stable,Stable,571,129141,58564
7987,10563080,3782663,94,0,Stable,Growth,621,3168924,613739
7988,1947489,490637,84,1,High Volume,Growth,609,490637,0
7989,1892936,829791,94,1,Stable,Growth,586,378587,451204
7990,3173867,1400490,86,0,Stable,Declining,517,634773,765717
7991,4281766,1121014,93,0,Stable,Stable,592,856353,264661
7992,4225764,2061398,95,0,Low Volume,Declining,523,845152,1216246
7993,4680416,393217,95,1,Stable,Declining,487,393217,0
7994,1196994,61661,95,0,High Volume,Stable,637,61661,0
7995,1562358,345751,87,0,Stable,Stable,562,312471,33280
7996,3668250,1175651,89,2,High Volume,Declining,493,733650,442001
7997,1300278,433175,87,0,Stable,Declining,495,260055,173120
7998,1974676,522105,87,0,Stable,Stable,551,394935,127170
7999,2727814,289687,94,0,High Volume,Declining,601,289687,0
8000,3715962,470901,96,0,Stable,Stable,573,470901,0
8001,500000,216733,95,0,Stable,Growth,617,150000,66733
8002,3512352,1547402,80,0,Low Volume,Growth,571,702470,844932
8003,1644621,580970,87,0,High Volume,Stable,600,493386,87584
8004,3491934,1218329,98,0,High Volume,Declining,613,1047580,170749
8005,3691507,1177432,93,0,Low Volume,Declining,498,738301,439131
8006,7176570,1014169,93,0,High Volume,Growth,676,1014169,0
8007,5854745,1421022,89,0,High Volume,Stable,630,1421022,0
8008,5822599,2114492,94,0,Stable,Stable,579,1164519,949973
8009,6292923,1836045,97,0,Low Volume,Growth,592,1258584,577461
8010,2503257,146093,98,0,Stable,Stable,586,146093,0
8011,2034474,974718,98,0,Stable,Growth,636,610342,364376
8012,3985820,1714569,94,0,High Volume,Declining,587,797164,917405
8013,3561402,595628,97,1,Low Volume,Growth,562,595628,0
8014,1548422,506963,94,0,Stable,Growth,623,464526,42437
8015,2741069,1275852,85,0,Low Volume,Stable,516,548213,727639
8016,1927863,179686,94,0,Stable,Growth,634,179686,0
8017,1001344,276735,78,0,Stable,Growth,581,200268,76467
8018,5567010,1421310,84,1,Stable,Declining,465,1113402,307908
8019,2072279,486141,90,0,High Volume,Growth,676,486141,0
8020,10210903,4349997,97,0,High Volume,Declining,576,2042180,2307817
8021,540152,119531,92,0,Stable,Growth,645,119531,0
8022,1270063,99889,90,0,Low Volume,Stable,522,99889,0
8023,2035213,162058,93,1,Unstable,Growth,539,162058,0
8024,4925345,341007,97,0,Stable,Stable,602,341007,0
8025,2729354,638984,87,0,High Volume,Growth,668,638984,0
8026,2541788,948806,94,0,Unstable,Stable,510,508357,440449
8027,804671,114002,94,0,Stable,Growth,645,114002,0
8028,785792,267885,92,0,High Volume,Stable,632,235737,32148
8029,2566372,921815,86,1,Unstable,Stable,464,513274,408541
8030,665780,109748,93,0,High Volume,Growth,683,109748,0
8031,1295617,414923,83,0,Stable,Growth,597,259123,155800
8032,2960101,1060281,93,2,High Volume,Growth,592,592020,468261
8033,903599,234914,95,0,Low Volume,Stable,574,180719,54195
8034,7161892,1443282,90,0,Unstable,Stable,508,1432378,10904
8035,5278482,1734605,95,1,Unstable,Growth,526,1055696,678909
8036,564031,276393,95,0,High Volume,Growth,695,169209,107184
8037,940440,227660,90,1,Low Volume,Declining,465,188088,39572
8038,500000,113140,94,1,Stable,Stable,546,100000,13140
8039,1060156,274496,92,0,Low Volume,Growth,581,212031,62465
8040,3660502,308574,87,1,Stable,Growth,564,308574,0
8041,1423863,425626,88,0,Stable,Growth,600,425626,0
8042,2866602,567340,87,0,Stable,Declining,519,567340,0
8043,586620,61384,85,0,Low Volume,Stable,530,61384,0
8044,3754179,975394,96,0,Low Volume,Growth,621,975394,0
8045,1271760,65525,79,1,High Volume,Stable,565,65525,0
8046,2002157,462105,88,0,Stable,Stable,579,400431,61674
8047,1840781,179625,85,0,High Volume,Stable,595,179625,0
8048,716950,43685,99,1,High Volume,Declining,548,43685,0
8049,788220,331851,97,1,Stable,Stable,547,157644,174207
8050,4300473,1988160,92,0,Low Volume,Growth,616,1290141,698019
8051,2728312,391386,84,0,Unstable,Growth,544,391386,0
8052,4592978,1344292,92,1,Stable,Declining,496,918595,425697
8053,2570797,450098,95,1,Low Volume,Growth,562,450098,0
8054,2223054,604915,92,1,Stable,Stable,541,444610,160305
8055,500000,123242,90,0,Low Volume,Growth,592,100000,23242
8056,1597111,273223,81,0,Low Volume,Declining,450,273223,0
8057,1939794,708368,92,1,Stable,Growth,588,387958,320410
8058,9459081,1011374,89,0,Stable,Growth,607,1011374,0
8059,3435130,253797,91,0,High Volume,Stable,633,253797,0
8060,6775671,2679466,96,1,High Volume,Stable,596,1355134,1324332
8061,3197981,1118233,89,0,Unstable,Growth,558,639596,478637
8062,1122375,307909,93,1,High Volume,Stable,609,307909,0
8063,2177525,567257,86,0,High Volume,Declining,554,435505,131752
8064,2395204,655891,96,0,High Volume,Growth,694,655891,0
8065,935350,230714,90,0,Stable,Growth,630,230714,0
8066,1457874,330648,97,0,High Volume,Growth,687,330648,0
8067,1681819,462266,82,0,High Volume,Growth,642,462266,0
8068,7163404,2061856,91,0,Unstable,Growth,576,1432680,629176
8069,500000,180678,86,1,Low Volume,Growth,552,100000,80678
8070,5202525,1925159,80,0,Stable,Stable,530,1040505,884654
8071,937117,206103,96,0,High Volume,Growth,687,206103,0
8072,661547,156187,90,0,Stable,Growth,603,156187,0
8073,5095935,1111748,95,0,Low Volume,Stable,537,1019187,92561
8074,3560881,1037787,89,0,Unstable,Declining,444,712176,325611
8075,5409217,1373990,99,1,High Volume,Stable,622,1373990,0
8076,3762377,1694268,88,0,Stable,Growth,629,1128713,565555
8077,10302282,3743464,96,0,Stable,Declining,536,2060456,1683008
8078,3100206,1408719,98,0,High Volume,Stable,643,930061,478658
8079,1749461,645746,94,0,Low Volume,Growth,586,349892,295854
8080,2608644,1270270,82,1,Low Volume,Stable,481,521728,748542
8081,5361612,1801939,97,0,Unstable,Declining,482,1072322,729617
8082,1062887,514010,94,0,High Volume,Growth,687,318866,195144
8083,1177011,142626,90,0,High Volume,Stable,609,142626,0
8084,1548554,113997,99,0,Low Volume,Growth,620,113997,0
8085,500000,155303,89,0,Stable,Growth,632,150000,5303
8086,2214335,1090719,93,0,Stable,Stable,590,442867,647852
8087,500000,118961,94,0,Stable,Growth,636,118961,0
8088,2068734,300834,94,0,Stable,Growth,626,300834,0
8089,3961890,1127925,99,0,High Volume,Growth,715,1127925,0
8090,1353899,462978,90,0,Stable,Growth,633,406169,56809
8091,7585072,1455047,90,1,High Volume,Growth,625,1455047,0
8092,616368,229071,95,0,Unstable,Growth,564,123273,105798
8093,5142287,2513558,90,0,Stable,Growth,605,1542686,970872
8094,3402802,1543625,89,0,Low Volume,Growth,603,1020840,522785
8095,502411,91044,94,0,Unstable,Declining,492,91044,0
8096,17341889,3416797,96,0,High Volume,Growth,688,3416797,0
8097,1884181,409232,84,1,High Volume,Stable,543,376836,32396
8098,982654,223602,89,0,Low Volume,Growth,604,223602,0
8099,643277,61204,98,0,Low Volume,Growth,612,61204,0
8100,1662754,653268,94,0,High Volume,Stable,652,498826,154442
8101,1790624,383915,89,0,Unstable,Stable,524,358124,25791
8102,2152448,959817,94,0,Stable,Growth,634,645734,314083
8103,1562446,729855,93,0,Stable,Growth,625,468733,261122
8104,3290599,200707,88,0,Low Volume,Declining,469,200707,0
8105,1454098,719526,88,0,High Volume,Stable,627,436229,283297
8106,500000,184755,92,0,Stable,Declining,520,100000,84755
8107,1759448,499994,98,0,Stable,Declining,550,351889,148105
8108,500000,112644,95,0,High Volume,Stable,636,112644,0
8109,2631373,745555,97,0,Stable,Growth,655,745555,0
8110,905787,177608,92,1,High Volume,Growth,634,177608,0
8111,2259577,746134,87,2,Stable,Stable,462,451915,294219
8112,5673178,521031,90,0,Stable,Growth,619,521031,0
8113,928199,305846,98,0,Stable,Stable,606,278459,27387
8114,4634343,805936,96,0,High Volume,Declining,584,805936,0
8115,1401829,81216,93,0,High Volume,Declining,598,81216,0
8116,8061062,2407981,86,0,High Volume,Stable,628,2407981,0
8117,1480481,459395,86,0,High Volume,Stable,589,296096,163299
8118,1012168,244900,95,1,High Volume,Declining,536,202433,42467
8119,3435904,283561,84,1,High Volume,Growth,609,283561,0
8120,1399140,632417,91,0,High Volume,Growth,675,419742,212675
8121,1011394,328849,78,0,Stable,Stable,532,202278,126571
8122,1352856,138087,98,0,High Volume,Stable,628,138087,0
8123,1913252,535555,93,0,High Volume,Declining,579,382650,152905
8124,5802179,1588430,96,1,Stable,Growth,597,1160435,427995
8125,500000,38590,86,0,High Volume,Growth,653,38590,0
8126,2019710,652542,91,0,High Volume,Growth,658,605913,46629
8127,3268765,1352441,87,1,Low Volume,Stable,496,653753,698688
8128,2314626,895884,82,1,Stable,Growth,567,462925,432959
8129,5654104,799130,82,0,High Volume,Stable,610,799130,0
8130,1868271,818362,95,0,High Volume,Growth,687,560481,257881
8131,1710607,349210,95,0,Unstable,Stable,541,342121,7089
8132,3184684,1515683,97,0,High Volume,Stable,638,955405,560278
8133,2146719,176646,77,0,Unstable,Stable,471,176646,0
8134,1450869,389985,90,0,High Volume,Growth,662,389985,0
8135,2996379,954964,94,0,Low Volume,Declining,509,599275,355689
8136,1176409,189922,97,0,Stable,Declining,534,189922,0
8137,1215977,482890,95,0,Stable,Growth,655,364793,118097
8138,1299649,431617,89,0,High Volume,Growth,676,389894,41723
8139,5852944,340344,96,0,Low Volume,Stable,574,340344,0
8140,500000,161883,90,0,Stable,Stable,584,100000,61883
8141,2720916,737818,89,0,Stable,Stable,587,544183,193635
8142,2037874,281661,87,0,Stable,Declining,531,281661,0
8143,516744,257383,80,0,High Volume,Declining,559,103348,154035
8144,2540271,1152579,91,1,Low Volume,Stable,504,508054,644525
8145,2901103,526923,88,0,High Volume,Stable,628,526923,0
8146,3177837,932638,93,1,High Volume,Growth,656,932638,0
8147,500000,96213,93,0,Stable,Growth,621,96213,0
8148,5915648,2360184,83,0,High Volume,Growth,637,1774694,585490
8149,1098889,514993,93,0,Unstable,Growth,564,219777,295216
8150,3434061,726211,98,0,High Volume,Stable,636,726211,0
8151,3587116,1479732,95,0,Stable,Growth,632,1076134,403598
8152,983273,269695,86,1,Stable,Stable,506,196654,73041
8153,3363081,768331,95,0,Stable,Growth,622,768331,0
8154,1456585,687930,90,1,Stable,Growth,578,291317,396613
8155,500000,139841,90,0,Stable,Growth,615,139841,0
8156,5046440,1313764,90,0,Unstable,Growth,550,1009288,304476
8157,1066576,376070,87,1,Low Volume,Growth,548,213315,162755
8158,1000895,167705,90,1,Stable,Declining,491,167705,0
8159,1436252,281731,87,0,High Volume,Growth,659,281731,0
8160,2465215,1157223,98,0,Low Volume,Declining,500,493043,664180
8161,1893966,672999,89,0,Stable,Growth,620,568189,104810
8162,3073887,1297139,96,0,High Volume,Declining,590,614777,682362
8163,679022,116792,94,0,High Volume,Stable,618,116792,0
8164,1094809,322646,94,1,Stable,Stable,561,218961,103685
8165,1807043,880262,88,0,Stable,Declining,533,361408,518854
8166,9050312,1750482,92,1,Stable,Stable,552,1750482,0
8167,1810204,221233,98,0,Stable,Growth,638,221233,0
8168,4724054,1322257,92,0,High Volume,Declining,578,944810,377447
8169,2044869,459113,90,0,High Volume,Declining,564,408973,50140
8170,1346573,164026,90,0,Stable,Stable,557,164026,0
8171,1627605,732175,97,0,High Volume,Growth,679,488281,243894
8172,1732826,859180,89,0,Stable,Declining,533,346565,512615
8173,3213646,982932,97,0,High Volume,Stable,647,964093,18839
8174,5954686,2373565,86,0,High Volume,Growth,659,1786405,587160
8175,2643845,1154216,93,0,High Volume,Declining,580,528769,625447
8176,5125108,1872929,94,0,High Volume,Growth,681,1537532,335397
8177,916363,64026,91,0,High Volume,Growth,673,64026,0
8178,1423025,172094,91,0,Stable,Stable,566,172094,0
8179,1110763,91022,94,0,High Volume,Growth,682,91022,0
8180,2549877,138830,82,0,Low Volume,Growth,567,138830,0
8181,1487836,279264,92,0,Stable,Growth,638,279264,0
8182,3554832,805383,81,0,Stable,Stable,536,710966,94417
8183,941471,149189,92,0,High Volume,Growth,668,149189,0
8184,2052204,162272,93,1,Low Volume,Declining,460,162272,0
8185,3434859,990745,91,0,Low Volume,Stable,548,686971,303774
8186,500000,86497,95,1,High Volume,Growth,645,86497,0
8187,10824310,4418664,95,0,Low Volume,Stable,549,2164862,2253802
8188,1580858,84771,81,0,High Volume,Growth,633,84771,0
8189,500000,214569,82,0,Stable,Growth,587,100000,114569
8190,2250077,1079225,93,0,Low Volume,Growth,584,450015,629210
8191,2036524,758118,94,0,Unstable,Stable,533,407304,350814
8192,1857022,705928,83,0,High Volume,Declining,552,371404,334524
8193,4381724,2059862,90,0,Unstable,Stable,506,876344,1183518
8194,3605446,519480,83,2,High Volume,Stable,537,519480,0
8195,2516302,1251997,94,0,Unstable,Declining,485,503260,748737
8196,2842301,1131425,94,0,Low Volume,Growth,605,852690,278735
8197,1823947,687549,92,0,Unstable,Declining,470,364789,322760
8198,8206136,1743728,81,1,Stable,Growth,554,1641227,102501
8199,607218,179494,96,0,Unstable,Stable,530,121443,58051
8200,2217124,763274,92,1,Low Volume,Growth,557,443424,319850
8201,2088632,687482,89,1,Stable,Stable,526,417726,269756
8202,3800428,1395681,84,0,Stable,Growth,593,760085,635596
8203,1009451,87895,99,0,Stable,Growth,643,87895,0
8204,500000,105021,96,0,Stable,Growth,644,105021,0
8205,2247791,551383,82,0,High Volume,Stable,576,449558,101825
8206,2483016,415367,90,0,Stable,Stable,589,415367,0
8207,6528446,833567,98,1,High Volume,Stable,584,833567,0
8208,717631,80746,92,0,Stable,Growth,642,80746,0
8209,4994036,1073081,96,0,Stable,Declining,531,998807,74274
8210,13176315,3584600,97,1,Stable,Growth,606,3584600,0
8211,1465619,114816,92,0,Stable,Growth,608,114816,0
8212,705912,335948,89,2,High Volume,Growth,588,141182,194766
8213,1431768,564631,94,0,Stable,Growth,650,429530,135101
8214,2005099,759699,93,0,High Volume,Stable,624,601529,158170
8215,3112791,397775,93,0,High Volume,Growth,666,397775,0
8216,1235374,397433,96,0,Low Volume,Stable,548,247074,150359
8217,6880204,1984087,87,0,High Volume,Stable,615,1984087,0
8218,812909,400041,95,1,High Volume,Stable,591,162581,237460
8219,500000,193226,90,0,Low Volume,Stable,544,100000,93226
8220,4805965,1485489,90,0,High Volume,Growth,669,1441789,43700
8221,500000,216433,96,0,High Volume,Stable,632,150000,66433
8222,1684023,201733,80,0,Stable,Stable,526,201733,0
8223,24013936,1365131,92,0,Stable,Growth,627,1365131,0
8224,1963747,708137,97,1,High Volume,Stable,612,589124,119013
8225,808864,76227,90,0,Stable,Declining,524,76227,0
8226,1893774,193061,93,2,Stable,Declining,443,193061,0
8227,1903794,733163,93,2,Stable,Growth,538,380758,352405
8228,2254683,387221,99,0,Low Volume,Stable,551,387221,0
8229,3367935,1121132,98,1,Unstable,Growth,540,673587,447545
8230,863467,399641,97,0,Stable,Stable,576,172693,226948
8231,7648640,1471702,91,0,Unstable,Stable,495,1471702,0
8232,2412301,356333,95,0,Stable,Declining,545,356333,0
8233,3546370,347379,87,0,Stable,Growth,598,347379,0
8234,1199578,130404,94,1,Low Volume,Growth,574,130404,0
8235,5548875,432813,87,0,Unstable,Stable,503,432813,0
8236,1614213,144374,90,0,Unstable,Stable,501,144374,0
8237,2475720,605071,90,0,Low Volume,Stable,529,495144,109927
8238,939887,182704,87,1,Stable,Growth,583,182704,0
8239,893101,328619,86,0,High Volume,Stable,600,267930,60689
8240,3438563,1518499,87,0,Stable,Growth,596,687712,830787
8241,1390417,560544,87,0,Low Volume,Growth,584,278083,282461
8242,1001432,289200,97,0,High Volume,Declining,597,200286,88914
8243,1185237,113900,92,0,High Volume,Stable,633,113900,0
8244,3468256,1281157,95,0,Stable,Declining,549,693651,587506
8245,1198726,255656,95,2,Low Volume,Growth,528,239745,15911
8246,1804648,159788,96,1,Stable,Stable,537,159788,0
8247,2006740,861112,95,0,Stable,Declining,534,401348,459764
8248,500000,101099,92,0,Unstable,Growth,567,100000,1099
8249,611151,90580,95,1,Stable,Declining,493,90580,0
8250,2594806,1147302,85,0,Low Volume,Growth,572,518961,628341
8251,1099511,501333,91,0,Stable,Growth,618,329853,171480
8252,4617574,935229,91,0,Low Volume,Stable,532,923514,11715
8253,4297077,900928,86,1,Low Volume,Growth,523,859415,41513
8254,3524802,1095624,90,0,Unstable,Declining,452,704960,390664
8255,8502046,3231191,86,0,Stable,Declining,495,1700409,1530782
8256,1855247,145483,96,1,High Volume,Growth,651,145483,0
8257,3332074,1056283,89,1,Low Volume,Declining,446,666414,389869
8258,1242305,594777,87,0,Low Volume,Growth,585,248461,346316
8259,14102969,2368484,88,0,High Volume,Stable,598,2368484,0
8260,9692926,4448784,99,0,Stable,Growth,630,2907877,1540907
8261,2001694,955961,90,1,Low Volume,Growth,555,400338,555623
8262,2701368,462256,96,0,Stable,Growth,652,462256,0
8263,5882180,2290467,92,0,Low Volume,Growth,590,1176436,1114031
8264,1762579,277516,96,0,Stable,Growth,652,277516,0
8265,1172561,447830,87,0,Stable,Stable,551,234512,213318
8266,3989561,1631088,92,0,Low Volume,Stable,558,797912,833176
8267,2111167,340410,90,0,Stable,Growth,639,340410,0
8268,2295349,854194,92,0,Stable,Growth,609,688604,165590
8269,1017219,422601,99,0,Low Volume,Growth,617,305165,117436
8270,501753,106051,91,0,High Volume,Growth,655,106051,0
8271,2395048,300498,85,0,Stable,Growth,616,300498,0
8272,4089649,373729,87,0,Stable,Growth,625,373729,0
8273,1655071,511287,95,0,High Volume,Growth,665,496521,14766
8274,6256576,3066624,97,0,Low Volume,Growth,608,1876972,1189652
8275,1129027,474561,95,0,Stable,Growth,620,338708,135853
8276,852763,209889,95,1,Unstable,Growth,533,170552,39337
8277,1878935,547671,96,0,Stable,Growth,648,547671,0
8278,1855985,326259,93,0,High Volume,Declining,566,326259,0
8279,3671001,452927,91,1,Stable,Stable,518,452927,0
8280,1066646,284727,88,1,High Volume,Declining,542,213329,71398
8281,5923721,1531730,97,0,Unstable,Growth,583,1184744,346986
8282,9564162,2724528,82,1,Stable,Growth,539,1912832,811696
8283,1921631,920004,87,0,Stable,Stable,552,384326,535678
8284,5388450,1733749,93,0,Stable,Growth,623,1616535,117214
8285,851541,274705,95,0,Stable,Growth,618,255462,19243
8286,4686409,504310,91,0,High Volume,Declining,562,504310,0
8287,4582802,2284160,90,0,Stable,Growth,629,1374840,909320
8288,3956023,1573628,96,0,Stable,Stable,606,1186806,386822
8289,1958226,870904,92,0,Stable,Declining,517,391645,479259
8290,500000,118218,84,1,Stable,Growth,580,100000,18218
8291,1186619,327457,89,1,Low Volume,Growth,534,237323,90134
8292,1201723,342416,83,0,Stable,Declining,484,240344,102072
8293,906545,124507,89,0,Stable,Stable,563,124507,0
8294,2186460,787716,90,0,High Volume,Growth,672,655938,131778
8295,1418101,647136,92,0,Stable,Stable,562,283620,363516
8296,1025110,126773,93,0,High Volume,Growth,691,126773,0
8297,849973,75514,88,0,Stable,Stable,550,75514,0
8298,1118601,427528,86,0,Low Volume,Growth,589,223720,203808
8299,4863162,841039,92,0,High Volume,Growth,684,841039,0
8300,1168440,386448,90,0,Low Volume,Growth,599,233688,152760
8301,1313294,476846,87,0,Stable,Growth,603,393988,82858
8302,1375932,268114,83,0,High Volume,Growth,666,268114,0
8303,2600449,1083906,93,0,Unstable,Stable,516,520089,563817
8304,2856191,849703,84,1,High Volume,Declining,521,571238,278465
8305,500000,220525,93,0,Stable,Growth,629,150000,70525
8306,4489753,1766637,97,1,Stable,Growth,618,1346925,419712
8307,6256268,2758132,90,1,Unstable,Stable,479,1251253,1506879
8308,855850,50557,96,0,Stable,Growth,635,50557,0
8309,910875,145355,94,0,Unstable,Stable,535,145355,0
8310,1383044,125170,93,0,Stable,Stable,587,125170,0
8311,1082947,269586,95,0,High Volume,Growth,684,269586,0
8312,2371757,1068434,91,0,Stable,Declining,533,474351,594083
8313,500000,130197,91,2,High Volume,Growth,608,130197,0
8314,810704,350525,85,2,High Volume,Declining,473,162140,188385
8315,6792691,1339724,97,0,High Volume,Growth,683,1339724,0
8316,943568,191362,87,0,High Volume,Growth,653,191362,0
8317,5361437,2428746,95,0,High Volume,Growth,670,1608431,820315
8318,2634675,636584,97,0,Stable,Stable,593,526935,109649
8319,500000,202697,94,0,High Volume,Growth,689,150000,52697
8320,3296142,515812,85,0,High Volume,Declining,535,515812,0
8321,1804630,860737,95,0,High Volume,Growth,670,541389,319348
8322,1377287,424976,89,0,Unstable,Stable,525,275457,149519
8323,2411997,944769,95,0,Stable,Growth,654,723599,221170
8324,2898508,261683,97,0,Stable,Declining,553,261683,0
8325,3492308,948856,93,0,Stable,Stable,579,698461,250395
8326,5089053,2317897,87,0,Stable,Declining,503,1017810,1300087
8327,2748343,1222098,97,0,High Volume,Growth,687,824502,397596
8328,659669,46880,98,0,Stable,Growth,654,46880,0
8329,1357403,253379,94,2,Low Volume,Stable,467,253379,0
8330,20882847,5210145,86,1,Stable,Growth,587,4176569,1033576
8331,3539843,451398,97,1,Low Volume,Growth,567,451398,0
8332,13196073,4994704,86,0,High Volume,Declining,545,2639214,2355490
8333,6054711,805461,95,1,Low Volume,Stable,519,805461,0
8334,2405917,495590,100,0,Stable,Declining,560,481183,14407
8335,2523420,879352,91,0,Stable,Stable,580,504684,374668
8336,1925577,514014,95,0,Stable,Growth,654,514014,0
8337,500000,191178,84,0,High Volume,Declining,569,100000,91178
8338,2011594,970682,97,1,Stable,Stable,538,402318,568364
8339,5222776,535053,100,1,Stable,Growth,591,535053,0
8340,1227252,453231,93,1,High Volume,Growth,627,368175,85056
8341,2756748,423588,92,0,High Volume,Growth,675,423588,0
8342,3918709,926832,90,0,Stable,Growth,603,926832,0
8343,957667,62046,87,1,Unstable,Growth,525,62046,0
8344,1381883,153608,98,0,Stable,Growth,655,153608,0
8345,878236,170290,95,0,High Volume,Growth,673,170290,0
8346,1027118,209423,84,1,Unstable,Declining,411,205423,4000
8347,707799,321916,90,0,High Volume,Stable,600,212339,109577
8348,964766,370292,98,0,High Volume,Stable,655,289429,80863
8349,6172192,3008835,89,0,Stable,Growth,633,1851657,1157178
8350,953237,304638,96,0,High Volume,Growth,685,285971,18667
8351,2193847,348320,86,0,Stable,Growth,625,348320,0
8352,1326037,261819,93,0,High Volume,Growth,680,261819,0
8353,5091549,987385,94,0,Stable,Declining,530,987385,0
8354,5659974,1114576,88,1,High Volume,Growth,619,1114576,0
8355,3958026,1396526,76,0,Low Volume,Stable,498,791605,604921
8356,2532982,731686,99,1,Low Volume,Growth,595,506596,225090
8357,1648131,368260,89,1,Unstable,Stable,450,329626,38634
8358,764135,89473,90,0,High Volume,Declining,564,89473,0
8359,9386876,562862,83,0,Stable,Growth,590,562862,0
8360,1079773,160320,93,0,Low Volume,Stable,544,160320,0
8361,3371664,331644,97,0,Unstable,Growth,589,331644,0
8362,4628079,1867200,83,1,Stable,Growth,563,925615,941585
8363,1271586,127952,92,0,Unstable,Declining,458,127952,0
8364,4548964,1709968,95,0,High Volume,Growth,684,1364689,345279
8365,3654137,816869,85,1,Stable,Growth,578,730827,86042
8366,7899982,655859,98,1,High Volume,Declining,552,655859,0
8367,1362079,566255,93,0,High Volume,Declining,569,272415,293840
8368,708786,220315,98,0,High Volume,Stable,652,212635,7680
8369,1323259,206551,97,0,Stable,Growth,648,206551,0
8370,2343328,1060606,80,1,Stable,Declining,448,468665,591941
8371,2077281,146170,86,0,High Volume,Growth,655,146170,0
8372,1447357,203815,94,2,High Volume,Growth,610,203815,0
8373,500000,194211,84,0,Unstable,Growth,541,100000,94211
8374,2888900,1066640,99,0,Stable,Growth,654,866670,199970
8375,9605780,1730695,98,0,High Volume,Stable,631,1730695,0
8376,2874534,223958,90,0,High Volume,Growth,689,223958,0
8377,3227791,1407753,83,0,High Volume,Stable,618,968337,439416
8378,3134425,599189,88,0,High Volume,Growth,678,599189,0
8379,2724069,376115,93,0,High Volume,Growth,663,376115,0
8380,4177956,1179135,93,0,High Volume,Growth,699,1179135,0
8381,2720426,1250314,82,0,Stable,Growth,600,816127,434187
8382,1543956,107453,82,0,Low Volume,Growth,565,107453,0
8383,1048854,413890,93,0,High Volume,Stable,615,314656,99234
8384,1624679,499772,92,0,High Volume,Stable,633,487403,12369
8385,2549234,615518,96,0,Low Volume,Growth,612,615518,0
8386,1539755,592553,91,0,High Volume,Declining,580,307951,284602
8387,2549661,1235619,90,1,Low Volume,Growth,567,509932,725687
8388,2817386,431462,98,1,Stable,Growth,596,431462,0
8389,3861412,442677,89,1,Low Volume,Stable,506,442677,0
8390,5532974,2549577,93,0,High Volume,Growth,697,1659892,889685
8391,2110438,740825,85,0,Low Volume,Growth,562,422087,318738
8392,696469,172093,88,0,Stable,Growth,596,139293,32800
8393,1504418,463311,89,0,Stable,Declining,512,300883,162428
8394,2053898,791832,96,1,High Volume,Stable,593,410779,381053
8395,500000,198932,93,0,High Volume,Declining,581,100000,98932
8396,6022010,2793926,96,0,Low Volume,Growth,597,1204402,1589524
8397,2221965,537892,81,0,High Volume,Growth,628,537892,0
8398,2690082,489689,92,1,Stable,Stable,534,489689,0
8399,5911565,1997216,97,0,High Volume,Growth,708,1997216,0
8400,1197667,283940,87,1,Stable,Growth,576,239533,44407
8401,3138431,996669,92,1,High Volume,Declining,533,627686,368983
8402,1815931,433996,80,0,Stable,Growth,596,363186,70810
8403,1711243,203378,95,0,Low Volume,Declining,504,203378,0
8404,1069013,279271,93,0,High Volume,Growth,664,279271,0
8405,7515534,2712454,87,0,Unstable,Growth,547,1503106,1209348
8406,1468277,601520,91,1,Stable,Growth,592,293655,307865
8407,3469675,943741,94,0,Stable,Stable,577,693935,249806
8408,500000,62179,82,0,High Volume,Growth,650,62179,0
8409,5096124,1205791,88,0,Stable,Stable,559,1019224,186567
8410,4600930,1858004,91,0,Stable,Stable,558,920186,937818
8411,2143493,505407,83,1,Stable,Stable,525,428698,76709
8412,1653568,600971,93,0,Low Volume,Stable,535,330713,270258
8413,2730513,759755,93,0,Low Volume,Growth,619,759755,0
8414,12373065,1961754,92,1,Stable,Stable,547,1961754,0
8415,500000,204134,88,0,High Volume,Stable,610,150000,54134
8416,3706586,325794,95,0,Unstable,Declining,481,325794,0
8417,956184,273660,89,0,High Volume,Stable,599,191236,82424
8418,1951415,281006,83,2,Low Volume,Growth,496,281006,0
8419,1626101,130380,98,0,High Volume,Stable,657,130380,0
8420,1407528,388929,91,0,Unstable,Declining,471,281505,107424
8421,1966229,540326,95,0,High Volume,Declining,568,393245,147081
8422,800237,294572,94,0,High Volume,Growth,688,240071,54501
8423,4516936,1739643,89,0,Stable,Growth,616,1355080,384563
8424,500000,188753,90,0,Stable,Growth,611,150000,38753
8425,3053538,715448,98,1,Stable,Growth,618,715448,0
8426,1526932,510393,87,0,Stable,Growth,600,458079,52314
8427,777050,240594,88,1,Low Volume,Declining,437,155410,85184
8428,2331230,558802,78,0,Low Volume,Stable,505,466246,92556
8429,570597,181875,91,1,Low Volume,Growth,573,114119,67756
8430,2046765,974795,98,1,High Volume,Growth,657,614029,360766
8431,635202,86897,94,0,High Volume,Growth,687,86897,0
8432,2867691,1312248,89,0,Stable,Declining,507,573538,738710
8433,946489,70092,91,0,Low Volume,Stable,542,70092,0
8434,1382225,260930,92,1,High Volume,Growth,623,260930,0
8435,2508410,450674,89,0,High Volume,Stable,625,450674,0
8436,1068714,354668,88,0,Unstable,Stable,492,213742,140926
8437,1892916,206425,88,1,High Volume,Growth,641,206425,0
8438,590624,264042,89,0,Stable,Stable,552,118124,145918
8439,3284420,1388811,87,1,High Volume,Stable,578,656884,731927
8440,8136991,2794484,97,0,Low Volume,Growth,616,2441097,353387
8441,18508990,4743599,94,2,Low Volume,Declining,410,3701798,1041801
8442,2132775,1002042,86,0,High Volume,Growth,663,639832,362210
8443,3724947,1578766,78,0,Stable,Declining,488,744989,833777
8444,500000,137346,93,0,Low Volume,Declining,484,100000,37346
8445,6597408,2413616,89,0,Stable,Growth,617,1979222,434394
8446,3689431,1125714,92,0,Stable,Stable,576,737886,387828
8447,1346277,423504,93,0,Stable,Declining,549,269255,154249
8448,5334708,1061283,92,0,Stable,Stable,582,1061283,0
8449,1617543,417226,91,0,Unstable,Stable,503,323508,93718
8450,1374472,117043,91,0,High Volume,Declining,572,117043,0
8451,2900135,611369,88,0,High Volume,Stable,610,611369,0
8452,846882,307522,92,0,Unstable,Growth,579,169376,138146
8453,4489715,2150336,86,0,High Volume,Growth,659,1346914,803422
8454,851886,411784,90,1,Low Volume,Growth,545,170377,241407
8455,855941,256847,95,0,Unstable,Growth,575,171188,85659
8456,957660,309305,91,0,High Volume,Growth,665,287298,22007
8457,3640385,486263,91,0,Stable,Growth,636,486263,0
8458,1210543,439292,99,0,High Volume,Growth,683,363162,76130
8459,674417,55165,89,0,Stable,Growth,628,55165,0
8460,1221336,217530,93,0,Stable,Stable,571,217530,0
8461,1932579,677878,88,0,Stable,Growth,625,579773,98105
8462,770829,146180,84,0,High Volume,Stable,600,146180,0
8463,789105,57156,83,0,Stable,Declining,502,57156,0
8464,10735183,4555386,96,1,Stable,Stable,567,2147036,2408350
8465,996045,188898,98,0,Stable,Stable,578,188898,0
8466,1531206,120042,88,0,Low Volume,Stable,541,120042,0
8467,1478015,123643,96,1,Unstable,Growth,534,123643,0
8468,1415388,231121,91,1,Low Volume,Growth,572,231121,0
8469,3259477,424081,88,0,High Volume,Declining,573,424081,0
8470,4233393,1686732,96,1,High Volume,Growth,638,1270017,416715
8471,1552282,302319,96,0,High Volume,Declining,582,302319,0
8472,737350,303872,91,0,Stable,Growth,638,221205,82667
8473,5496116,704771,88,1,Low Volume,Growth,533,704771,0
8474,1837152,499330,81,0,High Volume,Stable,592,367430,131900
8475,7914899,2846330,94,0,High Volume,Declining,591,1582979,1263351
8476,500000,171698,92,0,High Volume,Stable,640,150000,21698
8477,2318249,743018,98,0,Stable,Stable,608,695474,47544
8478,9201574,4289495,97,0,Unstable,Stable,542,1840314,2449181
8479,1494629,228434,98,2,Stable,Stable,505,228434,0
8480,1655486,450580,89,0,Stable,Growth,603,450580,0
8481,2511547,1124662,84,0,Stable,Growth,599,502309,622353
8482,1268015,107847,89,0,Low Volume,Stable,544,107847,0
8483,1544703,116084,89,1,Low Volume,Declining,437,116084,0
8484,1513216,234527,97,0,High Volume,Growth,704,234527,0
8485,1200278,401925,94,0,Stable,Growth,646,360083,41842
8486,5299300,884696,78,0,Stable,Stable,525,884696,0
8487,2867246,388821,88,1,Low Volume,Growth,535,388821,0
8488,2422965,621396,98,0,High Volume,Growth,688,621396,0
8489,3786137,1234732,91,1,Low Volume,Growth,572,757227,477505
8490,1604809,259740,94,0,Stable,Stable,580,259740,0
8491,1067294,197781,91,0,High Volume,Growth,692,197781,0
8492,1224325,399254,83,0,Stable,Growth,588,244865,154389
8493,1985590,944311,93,0,High Volume,Growth,666,595677,348634
8494,849693,300480,87,0,Unstable,Stable,502,169938,130542
8495,1328806,534588,92,1,High Volume,Growth,636,398641,135947
8496,1312057,282177,93,0,Unstable,Stable,518,262411,19766
8497,10849667,1871724,95,0,Low Volume,Growth,589,1871724,0
8498,500000,127210,91,1,Stable,Growth,563,100000,27210
8499,1717369,709634,95,0,High Volume,Growth,691,515210,194424
8500,7885649,2013481,95,1,Stable,Growth,610,2013481,0
8501,2185763,942122,90,0,Unstable,Growth,572,437152,504970
8502,3622714,1793053,98,0,Low Volume,Stable,569,724542,1068511
8503,2147599,176988,90,0,Stable,Growth,613,176988,0
8504,1162558,81884,90,0,Stable,Growth,621,81884,0
8505,500000,58658,90,0,Stable,Growth,631,58658,0
8506,2336967,521065,90,0,Unstable,Declining,450,467393,53672
8507,1066097,116172,96,1,Unstable,Stable,496,116172,0
8508,1045213,461774,88,0,High Volume,Declining,581,209042,252732
8509,1330161,80363,97,0,Unstable,Growth,589,80363,0
8510,8007500,1538295,97,0,Unstable,Declining,470,1538295,0
8511,13576760,1807238,87,0,Stable,Stable,541,1807238,0
8512,2359042,1106845,91,1,Stable,Growth,601,707712,399133
8513,1367078,480209,84,0,Low Volume,Stable,521,273415,206794
8514,773143,355966,93,0,Unstable,Growth,578,154628,201338
8515,2884413,1406290,94,0,Stable,Growth,645,865323,540967
8516,8254957,2259334,90,0,Stable,Stable,580,1650991,608343
8517,1626804,252876,88,0,Stable,Stable,582,252876,0
8518,500000,68589,95,0,High Volume,Growth,694,68589,0
8519,3388981,509410,89,1,Unstable,Declining,435,509410,0
8520,4361470,1608802,91,0,High Volume,Declining,566,872294,736508
8521,557559,38026,96,1,Low Volume,Stable,532,38026,0
8522,2283426,166947,93,0,Stable,Declining,533,166947,0
8523,2844736,920740,96,0,High Volume,Stable,646,853420,67320
8524,1870122,633832,95,1,Stable,Declining,514,374024,259808
8525,1053242,367969,90,1,High Volume,Stable,560,210648,157321
8526,4469333,971393,92,2,Unstable,Growth,500,893866,77527
8527,1435891,592557,85,0,High Volume,Growth,655,430767,161790
8528,604315,175331,96,0,Low Volume,Growth,604,175331,0
8529,500000,48730,85,1,Stable,Stable,508,48730,0
8530,5436683,2221943,97,0,Stable,Stable,580,1087336,1134607
8531,3247289,1555063,92,0,High Volume,Stable,615,974186,580877
8532,2127331,163839,87,1,High Volume,Stable,551,163839,0
8533,1394129,315224,93,1,Low Volume,Growth,550,278825,36399
8534,1298605,349821,97,1,Low Volume,Declining,465,259721,90100
8535,838534,97196,94,2,High Volume,Growth,596,97196,0
8536,1403999,618418,96,0,Low Volume,Growth,620,421199,197219
8537,500000,88934,94,1,Stable,Stable,527,88934,0
8538,1100361,442734,89,0,High Volume,Stable,626,330108,112626
8539,1546106,544148,94,1,Low Volume,Declining,469,309221,234927
8540,3229714,1030668,90,0,Stable,Growth,630,968914,61754
8541,1920428,262070,95,0,Stable,Growth,631,262070,0
8542,3745024,559194,89,1,High Volume,Declining,539,559194,0
8543,5834552,416043,92,0,Stable,Growth,626,416043,0
8544,4622915,731903,89,0,High Volume,Growth,669,731903,0
8545,2888962,593536,93,2,High Volume,Stable,531,577792,15744
8546,2001666,850539,96,0,High Volume,Stable,645,600499,250040
8547,904710,194401,94,0,Stable,Growth,639,194401,0
8548,3583875,1396205,95,0,Stable,Growth,631,1075162,321043
8549,7601057,1883154,92,0,High Volume,Growth,692,1883154,0
8550,2606933,1051091,88,0,Stable,Declining,507,521386,529705
8551,9191662,4497684,100,0,High Volume,Stable,645,2757498,1740186
8552,585103,92405,87,0,Unstable,Stable,505,92405,0
8553,787540,344985,87,0,Low Volume,Declining,463,157508,187477
8554,3930044,1296210,86,1,Low Volume,Stable,472,786008,510202
8555,2449592,1023396,80,0,High Volume,Growth,625,734877,288519
8556,5671849,1946656,99,0,Unstable,Growth,597,1134369,812287
8557,1958369,471531,94,0,Unstable,Growth,555,391673,79858
8558,990158,151132,96,0,Stable,Stable,570,151132,0
8559,1671322,136239,90,0,High Volume,Declining,553,136239,0
8560,581783,169289,97,0,Stable,Growth,659,169289,0
8561,803817,398409,94,1,High Volume,Declining,556,160763,237646
8562,4316499,1649415,86,0,Stable,Growth,597,863299,786116
8563,3985726,786406,94,1,Unstable,Declining,416,786406,0
8564,2650883,1119315,99,0,Low Volume,Stable,560,530176,589139
8565,500387,198175,85,0,Stable,Growth,618,150116,48059
8566,1488497,263071,94,1,Stable,Stable,523,263071,0
8567,744152,41999,93,0,Unstable,Declining,463,41999,0
8568,5082057,524332,94,0,High Volume,Growth,695,524332,0
8569,1242980,552862,92,0,Low Volume,Growth,579,248596,304266
8570,831845,354743,87,1,High Volume,Declining,512,166369,188374
8571,2030590,371281,99,1,Stable,Growth,599,371281,0
8572,1188112,211885,93,1,Low Volume,Stable,497,211885,0
8573,6497936,2643290,97,0,Stable,Declining,524,1299587,1343703
8574,1101465,519872,96,1,Stable,Stable,558,220293,299579
8575,647334,259330,88,0,Stable,Stable,549,129466,129864
8576,500000,161255,87,0,Stable,Stable,547,100000,61255
8577,1934522,307980,83,0,High Volume,Stable,596,307980,0
8578,1264840,362486,89,0,Stable,Declining,534,252968,109518
8579,632146,98033,94,1,Unstable,Growth,541,98033,0
8580,5133926,2123418,83,0,High Volume,Declining,550,1026785,1096633
8581,3381386,757878,92,2,High Volume,Stable,539,676277,81601
8582,1938501,824180,88,0,Stable,Stable,579,387700,436480
8583,5905892,1309479,95,1,Stable,Declining,486,1181178,128301
8584,3368671,1417763,93,1,High Volume,Growth,626,1010601,407162
8585,1026551,205303,94,0,Stable,Stable,586,205303,0
8586,863392,214173,90,0,Stable,Growth,610,214173,0
8587,3814748,1247307,94,2,Low Volume,Stable,476,762949,484358
8588,2722588,222243,84,0,Stable,Growth,597,222243,0
8589,2271153,1082643,90,0,Unstable,Growth,556,454230,628413
8590,1007318,310377,92,1,Low Volume,Declining,463,201463,108914
8591,3224724,898147,84,1,Stable,Stable,495,644944,253203
8592,1083385,463393,85,0,Stable,Growth,618,325015,138378
8593,1827411,803318,96,0,Low Volume,Growth,613,548223,255095
8594,6309426,1798295,93,0,Low Volume,Growth,584,1261885,536410
8595,1168618,546058,93,0,Stable,Stable,579,233723,312335
8596,563323,44577,99,1,High Volume,Growth,644,44577,0
8597,854236,86236,81,1,Stable,Declining,436,86236,0
8598,4392632,1399294,92,0,Low Volume,Declining,486,878526,520768
8599,2430931,508866,91,0,Stable,Declining,536,486186,22680
8600,1788518,463050,90,0,Unstable,Growth,541,357703,105347
8601,1319449,260770,86,0,Low Volume,Declining,476,260770,0
8602,2923488,678619,94,0,Stable,Stable,600,678619,0
8603,1005219,422384,90,0,High Volume,Stable,602,301565,120819
8604,2532031,802817,91,0,High Volume,Growth,661,759609,43208
8605,1104603,550982,95,0,Stable,Stable,595,220920,330062
8606,966921,390729,95,1,High Volume,Stable,613,290076,100653
8607,1190650,206161,95,1,High Volume,Stable,586,206161,0
8608,1468385,248091,94,0,High Volume,Growth,673,248091,0
8609,1906798,383560,90,0,Stable,Stable,558,381359,2201
8610,2393733,1028029,90,0,Low Volume,Growth,608,718119,309910
8611,500000,31140,93,0,Stable,Growth,640,31140,0
8612,1039115,159589,87,0,Stable,Growth,595,159589,0
8613,1449521,662740,98,0,Stable,Declining,531,289904,372836
8614,6609705,2233772,92,0,Stable,Stable,587,1321941,911831
8615,835677,127091,92,0,Low Volume,Declining,497,127091,0
8616,2258558,335656,82,0,Stable,Growth,599,335656,0
8617,6556872,2873078,91,0,Stable,Growth,629,1967061,906017
8618,693582,313631,94,0,Unstable,Stable,542,138716,174915
8619,2717384,449072,95,1,High Volume,Growth,641,449072,0
8620,1043596,249659,81,1,Low Volume,Growth,534,208719,40940
8621,1324165,563522,92,0,Stable,Growth,643,397249,166273
8622,1042895,413981,97,0,Stable,Growth,650,312868,101113
8623,1104070,459583,98,1,High Volume,Growth,669,331221,128362
8624,17496820,4956485,87,0,Low Volume,Stable,538,3499364,1457121
8625,3896404,1793114,94,0,High Volume,Stable,630,1168921,624193
8626,4786884,941476,96,1,Stable,Stable,545,941476,0
8627,2939044,354162,94,0,Low Volume,Growth,601,354162,0
8628,548529,202369,96,0,Stable,Growth,627,164558,37811
8629,2719521,796030,91,0,Stable,Declining,513,543904,252126
8630,4677824,2032812,94,0,Stable,Declining,551,935564,1097248
8631,1001771,86675,86,0,Low Volume,Stable,541,86675,0
8632,4291991,1844104,96,0,Stable,Declining,556,858398,985706
8633,3483224,633886,93,1,Stable,Stable,556,633886,0
8634,8724381,3007164,93,1,Stable,Growth,585,1744876,1262288
8635,1419441,96604,94,0,High Volume,Stable,634,96604,0
8636,823988,267229,96,0,Stable,Growth,624,247196,20033
8637,1484662,553441,87,0,Stable,Declining,496,296932,256509
8638,6252280,1350102,90,0,Stable,Growth,623,1350102,0
8639,500000,73467,92,0,High Volume,Stable,613,73467,0
8640,500000,145967,88,0,Low Volume,Growth,567,100000,45967
8641,2129752,905008,91,0,Low Volume,Declining,489,425950,479058
8642,1391550,272182,93,0,High Volume,Growth,660,272182,0
8643,1995055,326413,95,0,Stable,Stable,586,326413,0
8644,4223815,741368,85,0,High Volume,Growth,670,741368,0
8645,1274347,608003,90,0,Stable,Growth,615,382304,225699
8646,500000,105837,85,0,Stable,Growth,605,105837,0
8647,10176434,525327,88,0,High Volume,Growth,683,525327,0
8648,892889,358724,94,0,Stable,Stable,569,178577,180147
8649,849812,309904,92,1,Low Volume,Growth,542,169962,139942
8650,4794481,517112,96,0,Stable,Growth,624,517112,0
8651,1457756,718975,98,0,High Volume,Declining,577,291551,427424
8652,1884717,609947,91,1,Stable,Declining,487,376943,233004
8653,2917484,803331,78,0,Stable,Growth,569,583496,219835
8654,4717863,1047359,86,1,Unstable,Growth,505,943572,103787
8655,1518497,690009,96,0,Stable,Stable,582,303699,386310
8656,6688911,1068778,92,0,Low Volume,Growth,596,1068778,0
8657,500000,89298,94,0,Unstable,Growth,567,89298,0
8658,3641222,382637,91,0,Stable,Stable,576,382637,0
8659,1012951,396675,94,0,High Volume,Growth,672,303885,92790
8660,5943549,1890032,90,0,Low Volume,Stable,526,1188709,701323
8661,2221372,719902,94,0,Low Volume,Growth,584,444274,275628
8662,1157387,171654,95,0,Low Volume,Growth,621,171654,0
8663,3369493,1155823,94,0,Unstable,Growth,592,673898,481925
8664,4051309,1598064,90,0,High Volume,Growth,671,1215392,382672
8665,3313499,699313,86,0,Stable,Stable,563,662699,36614
8666,869995,357225,91,0,Stable,Stable,556,173999,183226
8667,1346186,278601,91,0,Stable,Growth,618,278601,0
8668,1976309,773058,95,1,Low Volume,Stable,511,395261,377797
8669,1918381,125037,88,0,High Volume,Growth,662,125037,0
8670,3612087,1076489,99,0,Stable,Growth,641,1076489,0
8671,500000,243143,88,0,Unstable,Stable,490,100000,143143
8672,2590760,1273514,90,0,High Volume,Declining,551,518152,755362
8673,1572245,277955,96,0,Stable,Declining,557,277955,0
8674,1013783,252056,87,1,Stable,Growth,573,202756,49300
8675,1094722,85761,96,1,High Volume,Declining,535,85761,0
8676,1670060,739843,85,2,High Volume,Stable,505,334012,405831
8677,500000,152929,81,1,Stable,Stable,499,100000,52929
8678,1131402,252637,93,0,High Volume,Stable,647,252637,0
8679,983967,99131,94,0,Stable,Stable,569,99131,0
8680,3036532,1445527,95,3,High Volume,Growth,565,607306,838221
8681,1040882,300397,92,0,Low Volume,Declining,501,208176,92221
8682,1669290,295994,97,0,Stable,Growth,651,295994,0
8683,6809446,1413619,86,2,Low Volume,Stable,460,1361889,51730
8684,4392817,754746,89,0,High Volume,Declining,576,754746,0
8685,4080855,1309197,93,0,High Volume,Stable,638,1224256,84941
8686,1329219,622717,94,0,Stable,Stable,597,265843,356874
8687,3061531,1333334,97,0,High Volume,Stable,641,918459,414875
8688,1644393,422891,89,0,Low Volume,Stable,557,328878,94013
8689,1694885,715114,83,0,High Volume,Growth,665,508465,206649
8690,2751752,661514,93,0,High Volume,Stable,629,661514,0
8691,1229853,201128,95,1,Low Volume,Growth,573,201128,0
8692,6546247,3224268,92,1,Low Volume,Growth,543,1309249,1915019
8693,1744356,325757,85,0,High Volume,Declining,573,325757,0
8694,3251700,636279,94,0,Stable,Growth,616,636279,0
8695,6353271,3147168,98,0,Stable,Growth,637,1905981,1241187
8696,4525882,499057,95,0,Stable,Stable,585,499057,0
8697,642335,251950,95,1,High Volume,Stable,612,192700,59250
8698,2830366,1333430,90,1,Low Volume,Growth,544,566073,767357
8699,3915977,1097679,96,0,High Volume,Stable,647,1097679,0
8700,4047016,206943,87,0,Stable,Growth,597,206943,0
8701,813714,178022,94,0,Low Volume,Stable,558,162742,15280
8702,1172175,117459,83,0,Stable,Stable,536,117459,0
8703,4393543,1042519,96,0,High Volume,Growth,702,1042519,0
8704,1077972,437131,93,0,Low Volume,Stable,569,215594,221537
8705,1560073,385994,91,0,Stable,Growth,641,385994,0
8706,6994961,1709333,96,1,Stable,Growth,608,1709333,0
8707,1908371,573571,74,0,Stable,Growth,581,381674,191897
8708,1108569,345608,85,1,High Volume,Stable,571,221713,123895
8709,982550,427737,87,0,Low Volume,Growth,561,196510,231227
8710,2587429,488403,95,0,High Volume,Stable,647,488403,0
8711,682475,286470,94,0,Stable,Growth,625,204742,81728
8712,1626809,495640,90,0,Stable,Growth,606,488042,7598
8713,2588488,479487,91,2,Low Volume,Stable,464,479487,0
8714,5605842,1024786,86,0,Low Volume,Stable,512,1024786,0
8715,3382205,718759,86,0,High Volume,Growth,658,718759,0
8716,1119898,369804,90,0,Low Volume,Declining,500,223979,145825
8717,5089731,783133,90,0,Stable,Stable,576,783133,0
8718,1560299,724213,85,0,Stable,Stable,549,312059,412154
8719,737807,227769,94,1,Unstable,Growth,534,147561,80208
8720,1727813,801717,91,0,Stable,Stable,569,345562,456155
8721,6265290,444096,90,1,Stable,Declining,489,444096,0
8722,2262978,462044,96,1,Stable,Stable,563,452595,9449
8723,2002721,120691,95,1,Stable,Growth,576,120691,0
8724,7346755,1267413,81,0,Low Volume,Declining,444,1267413,0
8725,630908,276276,86,0,Stable,Growth,620,189272,87004
8726,708936,47126,95,0,Stable,Declining,534,47126,0
8727,544336,134052,93,0,Stable,Stable,568,108867,25185
8728,2671414,274902,91,1,Stable,Stable,517,274902,0
8729,2265247,538174,81,0,Stable,Stable,539,453049,85125
8730,6811951,2911995,79,1,High Volume,Growth,615,2043585,868410
8731,2409139,795936,93,0,High Volume,Stable,626,722741,73195
8732,1434998,547510,99,0,High Volume,Growth,685,430499,117011
8733,1985608,411213,91,1,Low Volume,Declining,442,397121,14092
8734,2178541,1034761,91,0,Low Volume,Declining,504,435708,599053
8735,520524,192161,97,0,Stable,Growth,659,156157,36004
8736,17335471,4157210,92,1,Unstable,Declining,423,3467094,690116
8737,3005327,727016,95,0,High Volume,Growth,688,727016,0
8738,2345494,1086920,94,0,Low Volume,Growth,583,469098,617822
8739,3243395,1003448,91,0,High Volume,Growth,668,973018,30430
8740,3497394,1286589,92,1,High Volume,Growth,630,1049218,237371
8741,1771890,421118,94,0,High Volume,Stable,631,421118,0
8742,1196615,180284,98,0,Stable,Declining,563,180284,0
8743,3202879,1203007,90,0,Low Volume,Declining,509,640575,562432
8744,2699477,873337,87,0,Low Volume,Growth,567,539895,333442
8745,1037255,285872,87,1,Stable,Declining,468,207451,78421
8746,6170118,2041133,96,0,High Volume,Growth,692,1851035,190098
8747,2507211,360358,97,0,High Volume,Growth,683,360358,0
8748,3554964,1447839,86,0,Unstable,Growth,538,710992,736847
8749,6037718,2878019,95,1,High Volume,Declining,561,1207543,1670476
8750,2017785,910014,89,0,Low Volume,Stable,524,403557,506457
8751,2554997,497320,94,0,High Volume,Growth,688,497320,0
8752,3790550,882071,92,0,High Volume,Growth,675,882071,0
8753,1110267,459407,97,1,High Volume,Growth,664,333080,126327
8754,2070377,657971,80,0,High Volume,Growth,623,621113,36858
8755,2192250,650137,90,0,Stable,Stable,564,438450,211687
8756,922786,430931,92,0,High Volume,Declining,568,184557,246374
8757,12661918,3687293,88,1,Unstable,Growth,515,2532383,1154910
8758,643171,181196,99,0,High Volume,Declining,602,181196,0
8759,701879,48365,87,0,Low Volume,Declining,469,48365,0
8760,5673866,460931,96,0,Stable,Declining,522,460931,0
8761,3508198,187124,94,0,High Volume,Declining,591,187124,0
8762,872596,402232,91,1,High Volume,Declining,516,174519,227713
8763,3223026,753460,87,0,Stable,Growth,621,753460,0
8764,6415839,1673588,94,0,Stable,Declining,525,1283167,390421
8765,1935332,833014,96,0,Stable,Declining,542,387066,445948
8766,15855997,5139893,86,0,Stable,Growth,615,4756799,383094
8767,500000,162138,91,0,Stable,Stable,567,100000,62138
8768,3454053,633613,84,0,Stable,Declining,484,633613,0
8769,5041543,2143960,92,0,High Volume,Growth,686,1512462,631498
8770,4045336,504144,91,0,Low Volume,Growth,585,504144,0
8771,1683719,124456,84,1,High Volume,Declining,500,124456,0
8772,1571666,214095,87,1,High Volume,Stable,552,214095,0
8773,2828667,482236,93,0,High Volume,Growth,681,482236,0
8774,3807958,674161,92,0,High Volume,Declining,588,674161,0
8775,3210633,1129280,97,0,Stable,Declining,548,642126,487154
8776,4556413,674445,91,0,Stable,Declining,510,674445,0
8777,877563,311093,85,0,High Volume,Stable,620,263268,47825
8778,1652473,150391,91,0,High Volume,Growth,654,150391,0
8779,934706,108651,98,0,High Volume,Declining,597,108651,0
8780,1455864,406142,92,0,Stable,Growth,627,406142,0
8781,4466773,2076393,93,0,Low Volume,Growth,593,893354,1183039
8782,2161660,944225,95,0,Stable,Growth,638,648498,295727
8783,15958263,7754743,94,0,Low Volume,Growth,586,3191652,4563091
8784,2314548,793232,85,0,Stable,Growth,611,694364,98868
8785,2079740,736471,92,0,High Volume,Growth,688,623922,112549
8786,2158548,715041,89,0,Low Volume,Stable,537,431709,283332
8787,1190344,393133,88,0,Low Volume,Growth,580,238068,155065
8788,1893108,219987,89,0,Stable,Stable,581,219987,0
8789,4887690,1440317,83,0,Low Volume,Growth,574,977538,462779
8790,2172038,485951,95,0,Stable,Growth,639,485951,0
8791,1050979,261843,93,0,Stable,Stable,579,210195,51648
8792,945938,270179,100,0,Stable,Growth,640,270179,0
8793,1383101,149068,83,0,Stable,Declining,502,149068,0
8794,2103453,445447,100,1,Stable,Declining,503,420690,24757
8795,5151864,404691,93,0,High Volume,Declining,582,404691,0
8796,678479,333032,83,0,Unstable,Growth,527,135695,197337
8797,1535150,158639,92,0,Unstable,Growth,547,158639,0
8798,2225402,370165,92,0,High Volume,Growth,661,370165,0
8799,500000,225541,95,0,Stable,Growth,639,150000,75541
8800,1017767,271967,92,0,Low Volume,Growth,592,203553,68414
8801,1150940,127797,93,3,High Volume,Declining,441,127797,0
8802,1048870,233797,97,0,High Volume,Growth,675,233797,0
8803,2311741,236123,93,0,Stable,Growth,640,236123,0
8804,1743757,244295,94,0,High Volume,Growth,690,244295,0
8805,1271580,93351,86,0,Low Volume,Stable,543,93351,0
8806,2792283,690259,86,0,Low Volume,Stable,543,558456,131803
8807,7869143,3249848,91,0,Low Volume,Growth,597,1573828,1676020
8808,7358784,2308348,87,0,Low Volume,Stable,538,1471756,836592
8809,500000,161428,96,0,Stable,Declining,552,100000,61428
8810,3146048,441274,79,0,High Volume,Growth,629,441274,0
8811,1719564,352085,98,0,High Volume,Stable,638,352085,0
8812,2244794,966067,89,0,Low Volume,Stable,543,448958,517109
8813,1441758,129088,97,2,Low Volume,Growth,521,129088,0
8814,2178334,949903,89,0,Stable,Growth,602,653500,296403
8815,2238073,599044,94,0,Low Volume,Growth,608,599044,0
8816,1247733,532428,89,0,High Volume,Declining,576,249546,282882
8817,967921,186908,93,0,Stable,Growth,641,186908,0
8818,1384768,280387,92,1,Stable,Growth,603,280387,0
8819,2391443,928411,95,0,High Volume,Stable,633,717432,210979
8820,3201715,1291086,90,0,Low Volume,Declining,491,640343,650743
8821,3924224,601741,97,0,Low Volume,Growth,629,601741,0
8822,1335275,651337,96,1,Stable,Growth,590,267055,384282
8823,2488214,219014,93,0,Stable,Declining,512,219014,0
8824,4282305,346123,84,0,Stable,Stable,537,346123,0
8825,5037779,1601897,86,0,Low Volume,Stable,536,1007555,594342
8826,1891600,709791,94,0,Stable,Stable,591,378320,331471
8827,1661539,801524,95,1,Stable,Growth,599,332307,469217
8828,2310326,536517,95,0,Stable,Stable,579,462065,74452
8829,790352,48513,91,0,Stable,Growth,614,48513,0
8830,1698256,545655,88,0,Stable,Declining,514,339651,206004
8831,3597210,648804,90,1,Low Volume,Growth,547,648804,0
8832,3313640,811266,93,0,Stable,Stable,583,662728,148538
8833,1597237,430953,96,0,Stable,Declining,555,319447,111506
8834,2360006,186513,98,0,Stable,Growth,628,186513,0
8835,1025078,275430,90,0,High Volume,Stable,611,275430,0
8836,3480873,841828,82,0,High Volume,Growth,654,841828,0
8837,1863082,690542,95,0,Low Volume,Growth,606,558924,131618
8838,1589991,541471,97,1,Stable,Stable,570,317998,223473
8839,1484548,197960,82,2,High Volume,Declining,476,197960,0
8840,1885465,269174,91,2,Unstable,Declining,390,269174,0
8841,1385675,225800,90,0,High Volume,Growth,672,225800,0
8842,3356853,438162,93,0,Stable,Stable,574,438162,0
8843,1445222,499680,98,0,Stable,Growth,663,433566,66114
8844,7091244,3527848,98,0,Stable,Growth,656,2127373,1400475
8845,6402303,2198863,87,0,High Volume,Growth,679,1920690,278173
8846,971664,313854,84,0,Low Volume,Declining,455,194332,119522
8847,2096466,491553,92,0,High Volume,Stable,611,491553,0
8848,1178172,224632,94,0,Stable,Declining,522,224632,0
8849,1526796,702300,93,0,Low Volume,Growth,588,305359,396941
8850,9839761,4782624,93,1,High Volume,Growth,649,2951928,1830696
8851,1550275,424077,96,1,Low Volume,Declining,454,310055,114022
8852,2644998,477661,94,1,Stable,Declining,485,477661,0
8853,3057344,1212405,97,0,High Volume,Growth,676,917203,295202
8854,890463,97600,90,0,Stable,Stable,586,97600,0
8855,1000413,394678,88,1,Stable,Growth,571,200082,194596
8856,755536,316212,92,0,High Volume,Growth,688,226660,89552
8857,976005,103658,96,2,Stable,Stable,517,103658,0
8858,500000,244794,83,0,Unstable,Declining,438,100000,144794
8859,3065330,1512681,85,0,Stable,Stable,562,613066,899615
8860,10255811,4835859,84,0,Stable,Growth,582,2051162,2784697
8861,2231661,609725,85,0,Stable,Growth,601,609725,0
8862,638569,102639,92,2,Low Volume,Growth,521,102639,0
8863,1185623,369801,96,0,High Volume,Growth,685,355686,14115
8864,1373535,328234,85,0,Stable,Growth,622,328234,0
8865,878466,125337,97,0,Stable,Growth,644,125337,0
8866,3945736,949559,97,0,Stable,Stable,588,789147,160412
8867,3791256,1322202,88,0,Low Volume,Growth,602,1137376,184826
8868,786729,64442,92,0,Stable,Growth,620,64442,0
8869,3541514,708438,98,0,Stable,Stable,609,708438,0
8870,6725724,390144,94,0,Stable,Declining,537,390144,0
8871,9084194,3518063,95,0,Low Volume,Stable,566,1816838,1701225
8872,19622151,6638391,98,1,Stable,Growth,603,5886645,751746
8873,963575,75354,95,0,Stable,Growth,620,75354,0
8874,18989112,9193235,94,0,High Volume,Declining,588,3797822,5395413
8875,1493503,89879,91,0,Low Volume,Growth,580,89879,0
8876,1234316,389405,88,0,High Volume,Growth,682,370294,19111
8877,2575767,1028672,94,0,Stable,Growth,633,772730,255942
8878,1244633,503520,81,0,Low Volume,Growth,579,248926,254594
8879,2728426,178516,95,0,High Volume,Stable,652,178516,0
8880,689649,315781,98,0,Low Volume,Growth,600,206894,108887
8881,1638019,758900,93,0,Stable,Growth,617,491405,267495
8882,5545325,1678158,95,0,High Volume,Growth,698,1663597,14561
8883,1894283,505655,95,0,Low Volume,Growth,618,505655,0
8884,2220575,155863,83,0,High Volume,Declining,556,155863,0
8885,2899958,878337,97,0,Stable,Stable,579,579991,298346
8886,5058241,1184744,84,0,Low Volume,Declining,481,1011648,173096
8887,527456,209802,96,0,Stable,Stable,605,158236,51566
8888,3164860,733449,94,0,Low Volume,Growth,622,733449,0
8889,1599959,572164,95,0,Unstable,Growth,585,319991,252173
8890,2265510,216659,97,0,Stable,Stable,578,216659,0
8891,4629503,508451,96,0,High Volume,Stable,625,508451,0
8892,762723,86088,93,2,Low Volume,Stable,485,86088,0
8893,881945,62165,91,0,Stable,Declining,516,62165,0
8894,500000,146799,86,0,Stable,Growth,596,100000,46799
8895,1277829,520441,86,0,Stable,Declining,521,255565,264876
8896,5747904,1866258,89,0,Low Volume,Growth,591,1149580,716678
8897,1800419,555843,81,2,Stable,Declining,401,360083,195760
8898,678677,241800,83,0,High Volume,Growth,631,203603,38197
8899,1344398,272698,92,0,Low Volume,Stable,563,268879,3819
8900,603023,128371,96,0,Low Volume,Stable,569,120604,7767
8901,806010,154288,79,0,High Volume,Declining,543,154288,0
8902,2706198,1002508,89,0,Stable,Growth,606,811859,190649
8903,775219,95149,92,0,Unstable,Growth,547,95149,0
8904,4828795,269743,86,1,High Volume,Stable,565,269743,0
8905,1873097,596185,97,0,High Volume,Stable,660,561929,34256
8906,2123287,1006590,84,0,Stable,Growth,605,636986,369604
8907,1586914,514531,96,0,Stable,Growth,640,476074,38457
8908,3679466,1480303,98,0,Stable,Growth,664,1103839,376464
8909,3709946,1308705,95,0,High Volume,Declining,566,741989,566716
8910,2592267,709883,87,0,Stable,Declining,531,518453,191430
8911,3115285,1162863,89,0,Unstable,Declining,470,623057,539806
8912,1673333,704217,96,0,Stable,Growth,644,501999,202218
8913,3059501,462380,91,1,High Volume,Stable,597,462380,0
8914,1513140,304533,83,0,Low Volume,Growth,556,302628,1905
8915,1986302,299289,89,0,Stable,Stable,553,299289,0
8916,1591655,403449,89,0,Stable,Declining,509,318331,85118
8917,1375359,616545,99,0,Unstable,Stable,528,275071,341474
8918,1142478,234600,95,0,High Volume,Declining,577,228495,6105
8919,2882453,629845,93,1,Stable,Growth,585,576490,53355
8920,5657455,2473243,94,1,High Volume,Stable,586,1131491,1341752
8921,5060023,1426514,80,0,High Volume,Growth,633,1426514,0
8922,725595,211113,87,1,Stable,Declining,469,145119,65994
8923,5561411,2432342,80,0,Unstable,Stable,494,1112282,1320060
8924,1537200,416177,96,0,Low Volume,Stable,555,307440,108737
8925,3206166,1143642,98,0,High Volume,Stable,640,961849,181793
8926,960326,85027,89,1,Stable,Declining,476,85027,0
8927,2221257,289617,97,1,Low Volume,Stable,525,289617,0
8928,2548406,591152,98,0,High Volume,Growth,710,591152,0
8929,604596,164860,88,0,High Volume,Declining,566,120919,43941
8930,3225549,1563037,80,0,High Volume,Stable,592,645109,917928
8931,5819634,2832958,88,0,Stable,Stable,554,1163926,1669032
8932,1724214,746651,97,0,High Volume,Stable,640,517264,229387
8933,5886278,1130280,92,1,Stable,Growth,572,1130280,0
8934,1703585,824216,84,0,Low Volume,Declining,474,340717,483499
8935,3912424,1409268,87,0,Low Volume,Stable,533,782484,626784
8936,500000,113412,84,1,Stable,Growth,568,100000,13412
8937,13729018,5021439,88,0,High Volume,Declining,564,2745803,2275636
8938,6559117,376724,98,0,Low Volume,Declining,514,376724,0
8939,1578996,182800,90,0,Unstable,Growth,571,182800,0
8940,500000,211679,96,0,High Volume,Declining,595,100000,111679
8941,2496556,850098,95,0,Unstable,Stable,541,499311,350787
8942,624596,133593,90,0,Low Volume,Growth,571,124919,8674
8943,2830270,779173,93,1,Unstable,Declining,437,566054,213119
8944,2755894,1260309,99,1,Stable,Growth,595,551178,709131
8945,933669,312042,92,0,Unstable,Stable,530,186733,125309
8946,4861092,1114003,89,0,High Volume,Declining,584,972218,141785
8947,3777072,393371,93,0,High Volume,Declining,597,393371,0
8948,4328184,788535,99,1,High Volume,Growth,640,788535,0
8949,1996859,978966,88,1,Stable,Growth,575,399371,579595
8950,638950,157701,95,0,High Volume,Growth,687,157701,0
8951,4335285,1137266,89,0,Stable,Growth,602,1137266,0
8952,1597105,438196,93,0,Stable,Declining,544,319421,118775
8953,652245,292106,93,0,High Volume,Declining,578,130449,161657
8954,5848124,1881738,98,0,Low Volume,Stable,548,1169624,712114
8955,10633564,3850995,94,0,High Volume,Declining,573,2126712,1724283
8956,1918399,432093,95,0,High Volume,Growth,665,432093,0
8957,11153868,703691,92,0,Stable,Declining,544,703691,0
8958,2133025,1000256,98,0,High Volume,Stable,664,639907,360349
8959,1462467,697754,84,0,Low Volume,Stable,504,292493,405261
8960,1197364,571285,90,0,Stable,Growth,620,359209,212076
8961,7345996,3486845,92,0,High Volume,Growth,657,2203798,1283047
8962,1062234,442802,97,0,Stable,Growth,652,318670,124132
8963,3570497,1278482,98,0,Stable,Growth,652,1071149,207333
8964,1267642,545123,85,1,High Volume,Growth,622,380292,164831
8965,1371965,439366,84,0,Stable,Stable,564,274393,164973
8966,4520801,499396,83,0,Low Volume,Stable,524,499396,0
8967,1462957,330699,92,0,Stable,Growth,620,330699,0
8968,1434266,698606,84,1,High Volume,Growth,617,430279,268327
8969,4907346,1020787,88,1,Unstable,Declining,402,981469,39318
8970,7116438,3134951,91,0,Stable,Growth,623,2134931,1000020
8971,3320918,305342,90,0,Stable,Growth,619,305342,0
8972,1174302,235310,94,0,Stable,Growth,638,235310,0
8973,1317851,274019,96,0,High Volume,Stable,618,274019,0
8974,2113661,154765,96,0,High Volume,Growth,676,154765,0
8975,2563141,265522,94,0,Stable,Stable,599,265522,0
8976,899602,123177,96,0,High Volume,Growth,687,123177,0
8977,3535730,1509817,95,0,Stable,Growth,633,1060719,449098
8978,2123148,166733,91,0,Stable,Growth,613,166733,0
8979,502541,92676,86,1,Low Volume,Declining,431,92676,0
8980,943035,51470,96,1,Low Volume,Growth,572,51470,0
8981,1324701,480909,88,0,High Volume,Growth,655,397410,83499
8982,1870495,615648,87,0,Low Volume,Stable,517,374099,241549
8983,8988199,3058163,95,1,Unstable,Stable,467,1797639,1260524
8984,2398939,524102,97,0,Stable,Growth,659,524102,0
8985,1011943,145437,95,1,Stable,Stable,540,145437,0
8986,2365511,885042,98,1,Unstable,Growth,524,473102,411940
8987,1496036,620859,94,0,Low Volume,Growth,596,299207,321652
8988,2571003,288905,89,0,Stable,Growth,607,288905,0
8989,3154858,848888,79,1,Low Volume,Growth,497,630971,217917
8990,5216747,844706,90,0,High Volume,Stable,602,844706,0
8991,1944608,244336,95,1,Stable,Stable,546,244336,0
8992,7357041,2798960,94,0,Low Volume,Growth,587,1471408,1327552
8993,4099674,1197694,79,1,High Volume,Declining,498,819934,377760
8994,1125849,165819,93,1,Stable,Growth,596,165819,0
8995,11615890,2201211,90,1,High Volume,Growth,623,2201211,0
8996,2575607,1249154,96,0,Low Volume,Declining,519,515121,734033
8997,1016525,439043,98,0,Low Volume,Stable,572,203305,235738
8998,7439621,3317893,92,0,Stable,Stable,560,1487924,1829969
8999,10451145,2686001,85,0,High Volume,Stable,619,2686001,0
9000,1931060,638627,87,0,Stable,Declining,501,386212,252415
9001,1325208,290943,93,0,High Volume,Growth,659,290943,0
9002,1727352,146774,84,2,High Volume,Stable,508,146774,0
9003,3512313,809522,92,0,Unstable,Stable,498,702462,107060
9004,5511158,1748643,95,0,High Volume,Growth,686,1653347,95296
9005,3129519,560857,91,0,Stable,Growth,633,560857,0
9006,2150861,928264,86,0,Stable,Growth,590,430172,498092
9007,6572530,775526,97,0,High Volume,Growth,687,775526,0
9008,1543759,332229,90,0,High Volume,Stable,617,332229,0
9009,4523224,480397,94,0,Stable,Stable,576,480397,0
9010,1574660,365596,95,0,High Volume,Stable,652,365596,0
9011,2799128,189914,88,2,High Volume,Stable,548,189914,0
9012,1810566,312589,95,0,Stable,Declining,530,312589,0
9013,1896116,436734,86,0,Stable,Stable,578,379223,57511
9014,1466062,388762,92,0,Low Volume,Stable,555,293212,95550
9015,5814604,1713351,94,0,Unstable,Growth,586,1162920,550431
9016,1103127,191664,95,0,Low Volume,Growth,601,191664,0
9017,1096698,312963,94,0,Unstable,Declining,466,219339,93624
9018,10818788,3019005,91,0,Stable,Declining,529,2163757,855248
9019,4335199,833573,92,0,Stable,Declining,506,833573,0
9020,500000,211795,95,1,High Volume,Declining,554,100000,111795
9021,1261476,372815,92,0,Low Volume,Growth,605,372815,0
9022,500000,99761,88,1,Stable,Stable,508,99761,0
9023,926758,441417,90,1,Low Volume,Declining,430,185351,256066
9024,500000,215150,92,2,Stable,Stable,479,100000,115150
9025,1776949,874551,87,0,High Volume,Declining,551,355389,519162
9026,795278,287497,91,1,Low Volume,Stable,495,159055,128442
9027,2080095,458038,86,0,Stable,Stable,547,416019,42019
9028,540313,95304,94,0,High Volume,Declining,585,95304,0
9029,2118734,738364,88,1,Unstable,Stable,463,423746,314618
9030,1422700,699068,95,1,Low Volume,Declining,462,284540,414528
9031,6593286,2189115,89,0,Stable,Growth,619,1977985,211130
9032,6132331,2739476,81,0,Unstable,Stable,503,1226466,1513010
9033,3716439,736214,83,0,Low Volume,Growth,583,736214,0
9034,1526837,355950,93,0,High Volume,Growth,685,355950,0
9035,9706481,4443859,98,0,Unstable,Growth,578,1941296,2502563
9036,572388,223569,85,2,Stable,Growth,528,114477,109092
9037,645095,317151,92,0,High Volume,Stable,635,193528,123623
9038,1854218,739173,98,0,Low Volume,Stable,544,370843,368330
9039,12033807,3030499,93,1,High Volume,Declining,559,2406761,623738
9040,1686438,487348,83,0,Stable,Growth,581,337287,150061
9041,1712395,779537,88,0,High Volume,Stable,632,513718,265819
9042,625603,186580,99,0,High Volume,Growth,700,186580,0
9043,4225904,696973,94,0,Stable,Declining,543,696973,0
9044,4250474,1045740,84,0,Stable,Stable,535,850094,195646
9045,3727544,1052443,95,0,Stable,Declining,548,745508,306935
9046,1198550,112093,97,0,Stable,Growth,621,112093,0
9047,1126510,433361,91,2,Stable,Growth,543,225302,208059
9048,704682,69911,97,0,High Volume,Growth,678,69911,0
9049,2120363,492376,96,0,Low Volume,Growth,599,424072,68304
9050,835407,344255,92,0,Low Volume,Declining,476,167081,177174
9051,773025,201301,98,0,High Volume,Growth,695,201301,0
9052,1412748,605937,95,0,Stable,Growth,628,423824,182113
9053,1340663,273290,91,0,Stable,Stable,577,268132,5158
9054,1289309,620076,92,0,Unstable,Stable,523,257861,362215
9055,2879582,415411,90,0,Unstable,Growth,547,415411,0
9056,2112195,141979,95,0,High Volume,Stable,654,141979,0
9057,1574542,696880,96,1,Unstable,Stable,504,314908,381972
9058,2295383,891736,96,0,High Volume,Declining,592,459076,432660
9059,896971,138486,98,0,Stable,Growth,646,138486,0
9060,2156987,1063683,96,0,Stable,Growth,654,647096,416587
9061,2236633,617369,95,0,Stable,Growth,655,617369,0
9062,595742,284752,85,0,Stable,Declining,500,119148,165604
9063,4397536,1219274,97,0,Stable,Growth,624,1219274,0
9064,979554,256980,93,0,High Volume,Growth,696,256980,0
9065,2131311,537330,95,0,Unstable,Stable,540,426262,111068
9066,5033013,1010095,87,1,High Volume,Stable,583,1006602,3493
9067,4157986,1206505,97,0,Stable,Stable,600,1206505,0
9068,2037974,516931,88,0,Low Volume,Growth,574,407594,109337
9069,1483628,98715,84,0,Low Volume,Growth,564,98715,0
9070,4231256,707448,98,1,Low Volume,Stable,507,707448,0
9071,3401598,496311,87,1,Stable,Growth,574,496311,0
9072,1209005,532381,81,0,Stable,Stable,555,241801,290580
9073,1049774,335394,98,0,Low Volume,Growth,626,314932,20462
9074,500000,196829,94,0,Stable,Declining,523,100000,96829
9075,2242777,1077815,93,1,Stable,Growth,589,448555,629260
9076,1855829,630643,86,0,Stable,Growth,620,556748,73895
9077,4920659,2421823,86,0,High Volume,Stable,620,1476197,945626
9078,2642521,502855,88,0,High Volume,Growth,652,502855,0
9079,5765390,771526,97,0,Low Volume,Stable,571,771526,0
9080,1134961,262731,98,0,High Volume,Growth,703,262731,0
9081,4928377,1290544,96,0,Stable,Stable,583,985675,304869
9082,1298690,588193,93,0,Stable,Stable,570,259738,328455
9083,3693470,1115329,95,0,Stable,Stable,573,738694,376635
9084,617228,112015,92,0,High Volume,Growth,690,112015,0
9085,2393119,919401,88,0,Stable,Growth,599,478623,440778
9086,500000,138812,96,0,Stable,Stable,592,100000,38812
9087,1601242,196888,89,0,Low Volume,Declining,494,196888,0
9088,2820101,873016,95,0,Stable,Stable,587,564020,308996
9089,1306974,601375,94,0,High Volume,Growth,690,392092,209283
9090,855678,367240,92,2,Stable,Growth,547,171135,196105
9091,3901590,1225351,94,0,High Volume,Stable,635,1170477,54874
9092,1825254,400985,88,1,Stable,Growth,573,365050,35935
9093,1340219,119468,94,1,Unstable,Stable,488,119468,0
9094,2050341,535840,92,0,Stable,Growth,644,535840,0
9095,16343410,6348365,92,1,High Volume,Growth,648,4903023,1445342
9096,4989281,1058342,89,0,Stable,Growth,615,1058342,0
9097,5025618,783751,98,0,Unstable,Stable,539,783751,0
9098,2809275,1317890,96,1,Low Volume,Declining,485,561855,756035
9099,2265233,950718,87,0,Low Volume,Growth,563,453046,497672
9100,500000,168612,94,0,Stable,Stable,584,100000,68612
9101,1151776,128483,89,0,Stable,Growth,623,128483,0
9102,1349899,155520,92,1,High Volume,Declining,542,155520,0
9103,500000,48224,94,0,Unstable,Stable,511,48224,0
9104,785493,257118,90,0,High Volume,Growth,673,235647,21471
9105,500000,51002,95,0,High Volume,Declining,601,51002,0
9106,1922892,825271,95,0,Low Volume,Growth,625,576867,248404
9107,3817143,1896487,91,1,Stable,Growth,564,763428,1133059
9108,4806211,1032647,98,1,Stable,Growth,617,1032647,0
9109,2763000,702220,93,1,Low Volume,Growth,560,552600,149620
9110,917385,339662,91,1,Stable,Growth,564,183477,156185
9111,500000,235859,85,1,Stable,Stable,522,100000,135859
9112,500000,226171,99,0,High Volume,Declining,617,150000,76171
9113,718423,54540,93,1,Stable,Declining,508,54540,0
9114,973752,122773,98,0,Stable,Declining,547,122773,0
9115,1744888,679754,90,0,Low Volume,Stable,557,348977,330777
9116,880873,317116,96,0,Stable,Growth,657,264261,52855
9117,2600413,285911,89,0,Stable,Growth,618,285911,0
9118,1646531,454326,96,0,Low Volume,Growth,590,329306,125020
9119,1999558,802556,85,1,Stable,Growth,581,399911,402645
9120,4936664,732854,85,0,High Volume,Declining,536,732854,0
9121,771286,340970,92,1,Low Volume,Growth,558,154257,186713
9122,2771679,204653,96,0,Low Volume,Declining,500,204653,0
9123,1960718,788185,97,0,Low Volume,Growth,605,588215,199970
9124,1518466,496718,95,0,High Volume,Growth,697,455539,41179
9125,4025683,772286,90,0,Stable,Declining,512,772286,0
9126,4005630,1499787,95,0,Unstable,Stable,524,801126,698661
9127,929877,373871,95,0,High Volume,Stable,621,278963,94908
9128,1713882,805961,87,0,Stable,Growth,603,514164,291797
9129,2482978,535078,95,0,High Volume,Growth,703,535078,0
9130,1593741,571687,97,0,Low Volume,Growth,594,318748,252939
9131,3166119,1016886,92,1,Low Volume,Declining,462,633223,383663
9132,2482939,710972,98,1,Stable,Growth,615,710972,0
9133,8589482,3871171,97,0,High Volume,Stable,622,2576844,1294327
9134,582903,29976,92,0,Low Volume,Declining,490,29976,0
9135,1797759,318114,93,0,High Volume,Stable,613,318114,0
9136,958570,280118,88,0,High Volume,Stable,596,191714,88404
9137,3214833,418674,92,0,Low Volume,Declining,491,418674,0
9138,543760,249336,92,0,Low Volume,Stable,551,108752,140584
9139,2615721,893054,97,2,Stable,Growth,546,523144,369910
9140,1197757,317462,87,0,Stable,Growth,625,317462,0
9141,1102037,459126,80,0,Unstable,Growth,547,220407,238719
9142,623311,157635,95,1,High Volume,Growth,644,157635,0
9143,1366740,411927,94,0,High Volume,Growth,683,410022,1905
9144,4721327,241911,96,0,Low Volume,Growth,608,241911,0
9145,1943205,416944,95,1,High Volume,Growth,656,416944,0
9146,3276035,368409,96,1,High Volume,Growth,628,368409,0
9147,7509755,2706215,93,0,Stable,Growth,631,2252926,453289
9148,2448545,650241,85,0,Low Volume,Stable,522,489709,160532
9149,1268011,235585,91,0,High Volume,Declining,569,235585,0
9150,2881443,750687,96,0,Stable,Stable,604,750687,0
9151,1282809,185152,94,0,Stable,Growth,642,185152,0
9152,1324389,617548,91,0,High Volume,Growth,681,397316,220232
9153,587767,43664,91,0,Stable,Growth,615,43664,0
9154,4159918,1828025,96,0,Low Volume,Growth,589,831983,996042
9155,1455992,407840,89,0,Low Volume,Declining,475,291198,116642
9156,2293704,753541,93,0,Stable,Stable,590,458740,294801
9157,865645,161159,93,0,High Volume,Growth,680,161159,0
9158,2810177,1362975,95,0,High Volume,Stable,632,843053,519922
9159,1077816,190593,96,0,High Volume,Growth,685,190593,0
9160,1770253,557621,96,0,Low Volume,Growth,606,531075,26546
9161,4001824,1989057,97,0,Low Volume,Stable,578,800364,1188693
9162,3732570,1666564,95,0,Low Volume,Growth,615,1119771,546793
9163,1948121,567582,85,1,Stable,Declining,473,389624,177958
9164,500000,247834,96,0,High Volume,Stable,641,150000,97834
9165,21730958,7945195,79,2,Low Volume,Growth,489,4346191,3599004
9166,8013893,1153321,91,1,Unstable,Growth,521,1153321,0
9167,3534703,821883,95,0,Stable,Stable,580,706940,114943
9168,1085376,217642,92,0,Low Volume,Stable,557,217075,567
9169,1810523,370806,95,0,Low Volume,Growth,605,370806,0
9170,1283708,503477,93,0,Low Volume,Growth,608,385112,118365
9171,5449774,1705334,90,1,High Volume,Stable,566,1089954,615380
9172,2446092,164235,96,1,Unstable,Stable,505,164235,0
9173,1058823,471019,82,1,Low Volume,Growth,517,211764,259255
9174,1360545,249739,90,0,Low Volume,Stable,547,249739,0
9175,4861952,2424576,99,1,Unstable,Growth,540,972390,1452186
9176,7131829,3418898,97,0,Stable,Declining,527,1426365,1992533
9177,6733901,3186743,88,0,High Volume,Growth,660,2020170,1166573
9178,3633205,1507807,88,0,Low Volume,Growth,586,726641,781166
9179,1619941,241818,89,1,High Volume,Declining,519,241818,0
9180,500000,144842,92,0,Low Volume,Growth,595,100000,44842
9181,2514861,379584,87,0,Stable,Growth,595,379584,0
9182,1979861,330348,96,0,High Volume,Growth,673,330348,0
9183,2217710,720597,84,1,Stable,Declining,454,443542,277055
9184,2070122,141545,92,0,Low Volume,Growth,578,141545,0
9185,686245,333691,94,0,High Volume,Growth,692,205873,127818
9186,3096945,1435133,97,0,High Volume,Stable,623,929083,506050
9187,3287944,727771,93,0,Stable,Growth,616,727771,0
9188,3422463,964930,96,0,High Volume,Stable,624,964930,0
9189,4228093,1098263,95,0,Unstable,Stable,511,845618,252645
9190,3214689,1436934,82,0,Low Volume,Growth,556,642937,793997
9191,1428273,513994,94,0,Stable,Growth,635,428481,85513
9192,1873522,328147,77,0,High Volume,Growth,631,328147,0
9193,2132701,535476,92,0,Stable,Stable,575,426540,108936
9194,2161168,525239,94,1,Stable,Declining,500,432233,93006
9195,4406424,2122578,91,0,Stable,Growth,612,1321927,800651
9196,3318207,427683,94,0,Unstable,Stable,517,427683,0
9197,10447515,943508,96,1,Low Volume,Growth,557,943508,0
9198,11584461,5169896,95,2,Stable,Growth,572,2316892,2853004
9199,2113212,958360,94,0,Stable,Stable,594,422642,535718
9200,500000,221141,94,0,Stable,Stable,566,100000,121141
9201,5333221,1492980,87,0,Unstable,Growth,542,1066644,426336
9202,1286838,446385,99,0,Stable,Growth,634,386051,60334
9203,1044254,316945,93,0,Stable,Stable,564,208850,108095
9204,1441571,117130,87,1,Stable,Growth,573,117130,0
9205,1387044,441254,96,0,Stable,Growth,620,416113,25141
9206,3235894,181619,87,1,High Volume,Growth,638,181619,0
9207,569464,111754,92,0,High Volume,Declining,584,111754,0
9208,837204,393094,91,1,Stable,Growth,596,167440,225654
9209,2609129,487438,92,0,High Volume,Growth,659,487438,0
9210,3263645,1543449,86,1,Low Volume,Growth,524,652729,890720
9211,3312565,538491,80,0,High Volume,Stable,590,538491,0
9212,1056393,202355,85,0,Unstable,Declining,434,202355,0
9213,906537,301680,96,1,High Volume,Declining,559,181307,120373
9214,1322047,519210,88,0,High Volume,Growth,668,396614,122596
9215,2402206,662107,98,0,Unstable,Declining,476,480441,181666
9216,6506953,2908296,97,1,Unstable,Growth,541,1301390,1606906
9217,500000,34054,93,0,High Volume,Growth,677,34054,0
9218,1661808,772720,94,0,High Volume,Declining,569,332361,440359
9219,682732,94448,97,0,High Volume,Stable,660,94448,0
9220,528716,236816,96,0,Stable,Growth,637,158614,78202
9221,4297592,990115,89,1,Stable,Growth,564,859518,130597
9222,3065434,1302015,94,0,Stable,Declining,527,613086,688929
9223,2840660,1000621,98,1,Low Volume,Growth,581,568132,432489
9224,4142544,535108,98,0,Low Volume,Declining,503,535108,0
9225,1350823,625595,76,0,Unstable,Stable,468,270164,355431
9226,1402673,225105,92,0,Stable,Growth,642,225105,0
9227,11393852,1821456,97,0,High Volume,Growth,685,1821456,0
9228,1627805,677786,97,0,Stable,Growth,626,488341,189445
9229,3570105,348596,82,0,Low Volume,Growth,586,348596,0
9230,1992908,298769,88,0,High Volume,Stable,628,298769,0
9231,500000,138327,92,0,Unstable,Growth,566,100000,38327
9232,500000,211857,93,0,High Volume,Growth,675,150000,61857
9233,1247700,145192,91,1,Stable,Growth,588,145192,0
9234,4615270,1368200,92,0,Stable,Stable,565,923054,445146
9235,3725208,1378544,99,0,Unstable,Growth,600,1117562,260982
9236,4119580,1801360,92,0,High Volume,Growth,662,1235874,565486
9237,900192,423994,85,0,High Volume,Growth,666,270057,153937
9238,7222401,2911263,97,0,Low Volume,Growth,594,1444480,1466783
9239,916287,314995,82,1,Unstable,Declining,385,183257,131738
9240,2350784,576245,89,1,High Volume,Declining,545,470156,106089
9241,1966406,197525,93,0,Stable,Growth,623,197525,0
9242,1725282,637288,88,0,Unstable,Growth,568,345056,292232
9243,5785548,2873866,92,1,Low Volume,Growth,568,1157109,1716757
9244,1127949,430360,96,0,Unstable,Growth,582,225589,204771
9245,673549,38743,86,0,Unstable,Declining,438,38743,0
9246,2014731,550660,85,1,Stable,Stable,528,402946,147714
9247,1439978,470284,91,0,High Volume,Growth,688,431993,38291
9248,29559222,10651766,91,0,Unstable,Stable,509,5911844,4739922
9249,3406534,1273623,94,1,Low Volume,Declining,453,681306,592317
9250,1429060,430360,92,0,Stable,Growth,621,428718,1642
9251,851803,128207,95,0,Low Volume,Declining,517,128207,0
9252,500000,236995,96,0,Stable,Stable,593,100000,136995
9253,873117,317378,94,0,Stable,Growth,621,261935,55443
9254,2173726,340358,95,2,High Volume,Stable,547,340358,0
9255,6211189,1211460,99,0,Stable,Growth,644,1211460,0
9256,4863901,2261069,96,0,Unstable,Growth,578,972780,1288289
9257,2381583,1070208,91,0,Low Volume,Stable,545,476316,593892
9258,1531052,355688,84,0,Stable,Declining,504,306210,49478
9259,2458470,165303,95,0,High Volume,Growth,700,165303,0
9260,1309413,94047,93,0,High Volume,Growth,663,94047,0
9261,7839544,1393583,93,1,Low Volume,Stable,527,1393583,0
9262,1704271,567701,97,0,Stable,Growth,635,511281,56420
9263,1850432,578977,87,0,High Volume,Stable,614,555129,23848
9264,500000,167611,88,0,Unstable,Growth,545,100000,67611
9265,1695778,632148,99,0,Stable,Stable,595,339155,292993
9266,3871634,226740,96,0,Stable,Growth,650,226740,0
9267,843928,82105,93,1,High Volume,Growth,643,82105,0
9268,1087534,230304,93,0,Low Volume,Stable,566,217506,12798
9269,3738402,447438,96,2,Low Volume,Stable,470,447438,0
9270,608453,51046,83,0,Low Volume,Growth,572,51046,0
9271,4621550,1564090,86,1,High Volume,Stable,586,924310,639780
9272,1295341,540029,95,0,High Volume,Growth,667,388602,151427
9273,1453007,564758,97,0,Stable,Growth,632,435902,128856
9274,806853,336997,95,1,High Volume,Growth,661,242055,94942
9275,2682976,938064,87,1,Stable,Growth,552,536595,401469
9276,14187865,5404234,86,0,High Volume,Growth,657,4256359,1147875
9277,3705015,638376,87,0,Stable,Declining,530,638376,0
9278,993085,493418,93,1,Unstable,Declining,442,198617,294801
9279,4918413,651319,97,0,Low Volume,Growth,612,651319,0
9280,1539020,225501,95,0,High Volume,Declining,579,225501,0
9281,5954084,1071823,95,0,Stable,Growth,647,1071823,0
9282,3780403,1848237,85,0,High Volume,Growth,636,1134120,714117
9283,500000,247365,86,0,Unstable,Growth,562,100000,147365
9284,888008,362043,98,0,Stable,Stable,607,266402,95641
9285,4220686,1405809,84,0,Stable,Stable,558,844137,561672
9286,2238521,635803,98,0,High Volume,Stable,654,635803,0
9287,874139,425513,93,0,Stable,Stable,571,174827,250686
9288,1194369,433592,96,0,Stable,Declining,547,238873,194719
9289,500000,237564,98,0,Stable,Stable,599,100000,137564
9290,1847421,355532,89,0,High Volume,Declining,570,355532,0
9291,11623643,2327038,83,1,Stable,Stable,489,2324728,2310
9292,3775135,1640772,96,0,Stable,Growth,655,1132540,508232
9293,11436649,1343060,90,0,High Volume,Stable,637,1343060,0
9294,4016485,1910512,94,2,High Volume,Growth,620,1204945,705567
9295,4510793,1255640,96,0,High Volume,Growth,689,1255640,0
9296,9619116,4491033,95,0,Low Volume,Growth,594,1923823,2567210
9297,2681295,540433,94,0,Stable,Declining,538,536259,4174
9298,1706949,635295,91,0,Unstable,Stable,494,341389,293906
9299,4529518,1210712,94,0,Stable,Stable,580,905903,304809
9300,6344331,2106709,92,0,Low Volume,Stable,536,1268866,837843
9301,1350558,374061,87,1,Low Volume,Growth,534,270111,103950
9302,1113195,540124,85,0,Stable,Growth,617,333958,206166
9303,2215713,800864,96,1,Stable,Growth,618,664713,136151
9304,3856224,628925,79,0,Stable,Stable,534,628925,0
9305,3754527,1724659,97,0,Stable,Growth,649,1126358,598301
9306,634547,115686,91,0,High Volume,Declining,582,115686,0
9307,9150187,1987625,93,0,High Volume,Growth,661,1987625,0
9308,1187152,113914,84,0,Low Volume,Growth,583,113914,0
9309,1603899,729750,97,0,Stable,Growth,635,481169,248581
9310,963065,172148,86,0,Stable,Stable,560,172148,0
9311,17169808,2858995,98,0,Stable,Stable,607,2858995,0
9312,2406434,1116870,80,1,High Volume,Stable,570,481286,635584
9313,1003716,414020,90,0,High Volume,Stable,615,301114,112906
9314,3957562,449126,96,0,Low Volume,Growth,627,449126,0
9315,3668556,1453467,90,1,Unstable,Growth,505,733711,719756
9316,1706267,786359,86,0,Stable,Growth,603,511880,274479
9317,3884424,331458,92,0,Stable,Growth,643,331458,0
9318,1024552,431692,95,0,Stable,Growth,634,307365,124327
9319,1336634,396097,90,0,Stable,Stable,577,267326,128771
9320,500000,175569,99,0,Stable,Growth,652,150000,25569
9321,687515,186856,89,0,Stable,Declining,535,137503,49353
9322,8419867,3064927,97,0,Stable,Growth,626,2525960,538967
9323,7371582,481689,90,0,High Volume,Stable,615,481689,0
9324,2089909,821790,93,0,Unstable,Declining,481,417981,403809
9325,7499487,487502,94,0,Stable,Growth,623,487502,0
9326,1744433,444630,87,0,High Volume,Declining,554,348886,95744
9327,1631926,192460,90,0,Unstable,Growth,578,192460,0
9328,2074454,872533,88,1,High Volume,Declining,505,414890,457643
9329,1794187,342954,93,0,Stable,Stable,571,342954,0
9330,1669180,424543,93,0,Stable,Stable,577,333836,90707
9331,4949111,1202326,89,1,High Volume,Growth,640,1202326,0
9332,2235797,889011,99,0,Unstable,Declining,475,447159,441852
9333,3505997,934401,86,0,Stable,Growth,618,934401,0
9334,4524893,1832723,89,0,Stable,Growth,611,1357467,475256
9335,2704827,224714,92,0,Low Volume,Stable,529,224714,0
9336,912354,124278,99,1,Stable,Declining,518,124278,0
9337,671794,200323,95,1,Low Volume,Declining,461,134358,65965
9338,2233375,1063510,87,0,Low Volume,Stable,515,446675,616835
9339,1728898,144607,94,1,Stable,Growth,610,144607,0
9340,2126341,147542,95,0,Stable,Stable,597,147542,0
9341,1957457,235771,87,0,High Volume,Growth,668,235771,0
9342,15663738,5302471,98,0,High Volume,Growth,686,4699121,603350
9343,684072,157027,95,0,Unstable,Stable,508,136814,20213
9344,500000,210749,86,0,High Volume,Declining,565,100000,110749
9345,2586721,213068,88,1,Stable,Declining,466,213068,0
9346,1467194,203040,95,0,High Volume,Growth,692,203040,0
9347,2553190,472370,97,0,Unstable,Growth,595,472370,0
9348,3163237,1050285,98,2,High Volume,Growth,633,948971,101314
9349,5538774,1984696,97,0,Low Volume,Stable,564,1107754,876942
9350,593753,62873,93,1,Low Volume,Growth,547,62873,0
9351,1270125,602944,98,0,High Volume,Stable,630,381037,221907
9352,2794068,568509,93,2,Low Volume,Stable,485,558813,9696
9353,3672455,1362209,91,0,Unstable,Declining,478,734491,627718
9354,11464429,3277605,85,1,Stable,Declining,466,2292885,984720
9355,4259078,639889,97,0,High Volume,Growth,673,639889,0
9356,1894696,816240,90,0,Stable,Growth,607,568408,247832
9357,972525,406717,98,1,High Volume,Growth,637,291757,114960
9358,1262454,288133,96,0,Unstable,Stable,509,252490,35643
9359,1234082,388580,82,0,Stable,Stable,565,246816,141764
9360,3349049,556014,93,1,Stable,Growth,574,556014,0
9361,2435342,877778,91,1,Stable,Growth,584,487068,390710
9362,687681,130014,92,0,High Volume,Growth,658,130014,0
9363,1399015,601346,82,0,High Volume,Growth,642,419704,181642
9364,4000933,591431,91,1,Stable,Stable,522,591431,0
9365,2626939,148846,94,0,Stable,Growth,635,148846,0
9366,3124909,533824,89,1,Unstable,Declining,436,533824,0
9367,2693461,366240,86,0,High Volume,Growth,676,366240,0
9368,7283664,2030168,89,0,Stable,Stable,574,1456732,573436
9369,2394858,339271,83,0,Unstable,Stable,507,339271,0
9370,1455968,572829,85,0,High Volume,Growth,664,436790,136039
9371,953025,151166,90,1,Stable,Stable,537,151166,0
9372,2420991,891253,93,1,High Volume,Growth,622,726297,164956
9373,500000,155156,95,0,Unstable,Growth,572,100000,55156
9374,1710966,844896,93,0,High Volume,Stable,647,513289,331607
9375,1681721,840786,95,0,Low Volume,Growth,587,336344,504442
9376,665586,293714,89,1,Unstable,Growth,497,133117,160597
9377,943534,369858,90,1,Low Volume,Stable,512,188706,181152
9378,3789429,848474,83,0,Stable,Growth,594,757885,90589
9379,2384665,927574,84,1,Unstable,Stable,461,476933,450641
9380,2150973,1033551,82,0,Stable,Declining,515,430194,603357
9381,2533413,153322,90,1,Low Volume,Growth,562,153322,0
9382,2135267,623630,92,1,High Volume,Stable,601,623630,0
9383,5359011,793665,92,0,Stable,Growth,636,793665,0
9384,2188536,658846,78,1,Stable,Stable,509,437707,221139
9385,617497,160488,89,1,High Volume,Growth,642,160488,0
9386,7305251,2258023,89,1,Unstable,Declining,406,1461050,796973
9387,2666486,794434,92,0,High Volume,Growth,677,794434,0
9388,1237492,596531,88,0,Low Volume,Growth,591,247498,349033
9389,727434,217127,89,1,High Volume,Stable,592,145486,71641
9390,2721602,1172478,95,0,High Volume,Stable,646,816480,355998
9391,1805345,350091,90,0,Stable,Growth,612,350091,0
9392,6985293,1726382,93,0,Stable,Growth,642,1726382,0
9393,1503452,393432,78,0,High Volume,Stable,564,300690,92742
9394,1014692,178005,91,1,Stable,Growth,578,178005,0
9395,4059770,896826,89,0,High Volume,Growth,673,896826,0
9396,4156673,1327354,96,0,Low Volume,Stable,559,831334,496020
9397,2269162,705901,91,0,Low Volume,Growth,603,680748,25153
9398,3406124,1145806,93,1,Low Volume,Stable,517,681224,464582
9399,1923872,400777,87,1,Unstable,Growth,512,384774,16003
9400,2390689,459309,89,0,Low Volume,Growth,573,459309,0
9401,5035346,1637636,80,0,High Volume,Stable,609,1510603,127033
9402,3269850,358990,77,1,Unstable,Growth,464,358990,0
9403,1731642,283754,98,0,High Volume,Stable,637,283754,0
9404,5849636,403376,90,0,High Volume,Growth,666,403376,0
9405,500000,41337,98,0,High Volume,Growth,674,41337,0
9406,10238428,1633259,94,1,High Volume,Growth,623,1633259,0
9407,506476,29775,97,0,High Volume,Stable,638,29775,0
9408,1200592,192617,93,1,Stable,Growth,571,192617,0
9409,1918906,661522,94,1,Stable,Growth,592,383781,277741
9410,1763508,136669,94,0,Stable,Declining,524,136669,0
9411,4435402,1093466,96,0,High Volume,Stable,644,1093466,0
9412,850628,392054,95,0,Low Volume,Stable,537,170125,221929
9413,2442697,991926,90,0,Stable,Growth,604,732809,259117
9414,1248471,234022,94,0,Low Volume,Stable,568,234022,0
9415,2510802,1170442,95,0,High Volume,Stable,652,753240,417202
9416,1882634,373403,96,0,Stable,Growth,619,373403,0
9417,2135793,176485,91,0,Low Volume,Growth,602,176485,0
9418,1277046,635107,88,0,High Volume,Growth,649,383113,251994
9419,1318426,582098,83,0,Unstable,Declining,445,263685,318413
9420,2495047,647888,92,0,Stable,Stable,568,499009,148879
9421,4218425,1475898,85,1,Unstable,Stable,439,843685,632213
9422,1228589,432528,80,0,Low Volume,Growth,564,245717,186811
9423,989531,136077,93,1,Unstable,Declining,435,136077,0
9424,3238977,453528,96,0,High Volume,Growth,683,453528,0
9425,1931866,504818,97,0,Low Volume,Growth,597,386373,118445
9426,3853138,1773245,90,1,Low Volume,Declining,432,770627,1002618
9427,960647,52353,94,0,Unstable,Stable,516,52353,0
9428,500000,201064,94,1,High Volume,Growth,638,150000,51064
9429,1294450,98232,99,0,High Volume,Growth,679,98232,0
9430,1074019,284830,94,0,Low Volume,Declining,483,214803,70027
9431,1861642,627453,90,0,High Volume,Stable,604,558492,68961
9432,1191262,427713,90,2,High Volume,Growth,593,238252,189461
9433,3586953,273741,93,0,Stable,Growth,639,273741,0
9434,1574550,375328,90,0,Stable,Growth,635,375328,0
9435,2236404,699383,91,0,Stable,Stable,559,447280,252103
9436,2249251,179311,90,0,High Volume,Growth,674,179311,0
9437,2317418,256753,82,0,Stable,Declining,495,256753,0
9438,1944853,678058,86,0,High Volume,Growth,662,583455,94603
9439,2983121,849405,89,0,Low Volume,Growth,568,596624,252781
9440,1049134,128858,86,0,Stable,Growth,589,128858,0
9441,6074039,1766681,97,1,Stable,Stable,540,1214807,551874
9442,1640924,755993,94,0,Stable,Stable,567,328184,427809
9443,694370,39589,84,1,Stable,Growth,552,39589,0
9444,2304694,781718,95,0,High Volume,Growth,693,691408,90310
9445,1003551,83438,95,0,Stable,Growth,644,83438,0
9446,3376221,178610,92,0,Stable,Growth,626,178610,0
9447,11613566,1368014,92,1,Stable,Growth,592,1368014,0
9448,1056786,253954,88,0,Low Volume,Declining,499,211357,42597
9449,2586711,1063280,96,0,High Volume,Declining,600,776013,287267
9450,500000,88402,86,1,Unstable,Growth,514,88402,0
9451,2850840,945204,95,0,Stable,Growth,651,855252,89952
9452,976206,229428,88,0,Stable,Declining,499,195241,34187
9453,1202763,186969,96,0,High Volume,Growth,706,186969,0
9454,821569,231199,82,0,Low Volume,Growth,553,164313,66886
9455,3561602,1456193,97,0,Stable,Growth,632,1068480,387713
9456,4438573,1884714,90,0,Unstable,Growth,542,887714,997000
9457,2020202,870573,95,0,Stable,Stable,573,404040,466533
9458,992973,200929,97,0,Low Volume,Growth,602,200929,0
9459,7071749,2878592,97,0,High Volume,Growth,710,2828699,49893
9460,1087804,158254,88,0,High Volume,Stable,596,158254,0
9461,500000,191146,98,1,Unstable,Declining,456,100000,91146
9462,2861084,1364088,97,0,High Volume,Growth,683,858325,505763
9463,819279,46031,95,0,Unstable,Declining,466,46031,0
9464,4372682,1085141,93,0,High Volume,Declining,595,874536,210605
9465,1461670,499156,86,0,Stable,Growth,594,292334,206822
9466,3213819,1175612,91,1,Stable,Growth,568,642763,532849
9467,6084166,786315,91,1,Unstable,Stable,493,786315,0
9468,753823,367476,98,0,Stable,Declining,527,150764,216712
9469,1260792,412114,87,1,High Volume,Declining,523,252158,159956
9470,1866290,231333,92,1,Stable,Growth,569,231333,0
9471,6783753,401836,96,0,Low Volume,Growth,590,401836,0
9472,1170912,471256,89,1,High Volume,Stable,594,234182,237074
9473,1232305,105814,94,0,High Volume,Growth,688,105814,0
9474,2906652,329826,85,0,Low Volume,Declining,465,329826,0
9475,1249454,385673,96,0,Low Volume,Stable,566,249890,135783
9476,2240077,720358,87,1,High Volume,Growth,629,672023,48335
9477,573074,205790,95,0,Stable,Growth,651,171922,33868
9478,11657543,2647210,91,0,High Volume,Stable,610,2647210,0
9479,674571,268651,90,0,Low Volume,Growth,601,202371,66280
9480,1532786,748707,89,0,Stable,Declining,510,306557,442150
9481,1931901,332273,91,0,High Volume,Growth,672,332273,0
9482,9158111,3355192,92,0,Stable,Declining,529,1831622,1523570
9483,687023,321397,95,0,Unstable,Stable,533,137404,183993
9484,9693473,3478300,83,0,High Volume,Stable,579,1938694,1539606
9485,3633625,1295385,93,0,High Volume,Stable,618,1090087,205298
9486,2768113,417148,95,1,High Volume,Growth,643,417148,0
9487,901931,262289,88,1,Unstable,Growth,532,180386,81903
9488,3131157,949164,92,0,Low Volume,Stable,543,626231,322933
9489,1111489,405758,99,0,Unstable,Stable,554,222297,183461
9490,5462019,2723197,90,0,Stable,Growth,606,1638605,1084592
9491,911777,59393,93,1,High Volume,Growth,642,59393,0
9492,1811151,143723,92,0,High Volume,Growth,677,143723,0
9493,1271594,108184,90,0,Low Volume,Stable,535,108184,0
9494,899848,345848,77,0,High Volume,Declining,516,179969,165879
9495,3587822,399537,85,0,Stable,Stable,541,399537,0
9496,3043038,1004517,96,1,Stable,Growth,595,608607,395910
9497,5215827,1022829,98,1,Stable,Stable,568,1022829,0
9498,500000,127897,92,1,Stable,Growth,589,100000,27897
9499,4645161,683064,96,0,High Volume,Declining,583,683064,0
9500,14714723,6470769,93,0,Stable,Growth,627,4414416,2056353
9501,1381509,433473,94,1,Stable,Growth,590,276301,157172
9502,9030505,4289973,90,0,Low Volume,Growth,570,1806101,2483872
9503,1606343,495667,94,1,Stable,Stable,543,321268,174399
9504,661372,69946,83,1,High Volume,Stable,569,69946,0
9505,1552682,197022,87,0,High Volume,Growth,654,197022,0
9506,4586204,2270553,89,1,High Volume,Stable,586,917240,1353313
9507,1014046,381793,92,0,High Volume,Growth,686,304213,77580
9508,1226566,88528,94,0,Stable,Stable,593,88528,0
9509,3187768,1168959,97,0,High Volume,Growth,687,956330,212629
9510,1987619,468040,89,1,High Volume,Stable,584,397523,70517
9511,3165110,595812,87,0,Stable,Declining,524,595812,0
9512,2398283,286181,92,0,Stable,Growth,622,286181,0
9513,2910107,1245400,99,0,Stable,Growth,632,873032,372368
9514,1403050,110460,91,1,Stable,Growth,591,110460,0
9515,2386611,430607,99,0,Low Volume,Declining,505,430607,0
9516,944208,177391,93,0,Stable,Growth,639,177391,0
9517,5557989,680339,93,1,Stable,Growth,598,680339,0
9518,1193714,332668,90,0,High Volume,Stable,608,332668,0
9519,4891835,270353,92,2,Stable,Stable,485,270353,0
9520,1644775,305005,97,1,Stable,Declining,518,305005,0
9521,2330514,1095652,97,0,High Volume,Stable,653,699154,396498
9522,1334448,253196,96,1,High Volume,Declining,530,253196,0
9523,879583,186653,81,0,High Volume,Growth,651,186653,0
9524,500000,131462,91,0,High Volume,Growth,691,131462,0
9525,852340,258056,92,0,Stable,Declining,546,170468,87588
9526,1530145,633356,89,0,Stable,Declining,510,306029,327327
9527,2349007,318630,88,0,Stable,Growth,608,318630,0
9528,4449505,1967953,93,0,High Volume,Growth,668,1334851,633102
9529,1388027,542576,83,0,Stable,Growth,594,277605,264971
9530,979141,367367,98,0,Stable,Stable,606,293742,73625
9531,625201,55682,94,0,Stable,Stable,589,55682,0
9532,2911127,173906,86,0,High Volume,Growth,676,173906,0
9533,5995715,1902475,81,0,Low Volume,Growth,566,1199143,703332
9534,5460573,2393971,91,0,High Volume,Growth,667,1638171,755800
9535,3498855,1095137,97,0,Low Volume,Growth,603,1049656,45481
9536,3304629,482329,91,0,High Volume,Growth,671,482329,0
9537,7710542,699608,93,2,Stable,Growth,539,699608,0
9538,2586109,943460,87,0,Stable,Growth,603,775832,167628
9539,3324746,1246104,98,0,Stable,Growth,663,997423,248681
9540,1533975,195795,87,0,Stable,Growth,622,195795,0
9541,666880,41804,93,0,Unstable,Declining,474,41804,0
9542,1147299,268155,93,0,Low Volume,Stable,544,229459,38696
9543,1968284,614544,84,0,High Volume,Stable,598,393656,220888
9544,2081560,765392,93,0,Stable,Stable,571,416312,349080
9545,9258279,3837328,84,0,Low Volume,Stable,514,1851655,1985673
9546,2115965,687142,81,0,High Volume,Growth,637,634789,52353
9547,5091458,508618,97,0,High Volume,Growth,681,508618,0
9548,1399938,500004,96,0,Unstable,Declining,458,279987,220017
9549,1545193,761594,98,0,Unstable,Growth,598,309038,452556
9550,684740,313277,85,0,Stable,Growth,602,205422,107855
9551,1094861,484203,92,1,High Volume,Growth,616,328458,155745
9552,3022471,562109,91,0,High Volume,Declining,574,562109,0
9553,1994788,773688,95,0,Stable,Growth,616,598436,175252
9554,4215804,1825429,81,0,Low Volume,Growth,572,843160,982269
9555,2292155,814281,83,0,Stable,Stable,546,458431,355850
9556,1495598,243413,95,0,High Volume,Declining,565,243413,0
9557,11057699,5299129,89,1,Stable,Growth,559,2211539,3087590
9558,1839266,465093,87,2,Stable,Growth,520,367853,97240
9559,5027336,545026,95,0,Stable,Declining,529,545026,0
9560,1438387,142976,91,0,Stable,Growth,605,142976,0
9561,3497922,1194133,95,0,High Volume,Growth,677,1049376,144757
9562,4165773,1028818,88,0,Stable,Growth,617,1028818,0
9563,2342651,216737,98,0,Stable,Stable,612,216737,0
9564,500000,191582,93,0,Stable,Growth,638,150000,41582
9565,2011924,824278,97,0,High Volume,Stable,652,603577,220701
9566,5306102,1997413,85,0,Low Volume,Stable,539,1061220,936193
9567,3023678,426391,94,0,Low Volume,Stable,566,426391,0
9568,2832502,1020831,84,0,Stable,Stable,546,566500,454331
9569,500000,27413,94,0,Low Volume,Declining,515,27413,0
9570,1114187,208688,91,0,Stable,Stable,591,208688,0
9571,2755436,632289,93,1,Stable,Growth,602,632289,0
9572,2753289,1172519,85,1,Stable,Growth,562,550657,621862
9573,5239483,1182433,94,0,Stable,Stable,596,1047896,134537
9574,1765786,97244,94,1,Unstable,Stable,484,97244,0
9575,2743265,572124,86,1,Stable,Stable,529,548653,23471
9576,2008903,551476,98,1,Unstable,Declining,442,401780,149696
9577,900266,429474,91,0,Stable,Growth,631,270079,159395
9578,500000,236733,98,0,High Volume,Growth,713,200000,36733
9579,2799098,367783,82,0,Stable,Declining,487,367783,0
9580,2278796,303800,87,1,Stable,Growth,554,303800,0
9581,1209188,149361,86,0,Unstable,Growth,549,149361,0
9582,542890,219879,96,1,Stable,Stable,542,108578,111301
9583,3281436,172964,88,2,Stable,Stable,484,172964,0
9584,1602802,171868,77,1,High Volume,Stable,555,171868,0
9585,3095623,904175,89,0,High Volume,Declining,565,619124,285051
9586,8808598,1421734,97,0,High Volume,Growth,678,1421734,0
9587,500000,45780,93,1,Low Volume,Growth,574,45780,0
9588,1132932,240119,94,1,Low Volume,Declining,456,226586,13533
9589,1676971,290776,92,0,High Volume,Growth,659,290776,0
9590,6349337,1777795,91,0,Stable,Stable,577,1269867,507928
9591,535458,262725,96,0,Stable,Growth,654,160637,102088
9592,9329471,988337,91,1,High Volume,Declining,538,988337,0
9593,2210401,481264,87,1,Stable,Declining,459,442080,39184
9594,1836183,861892,96,0,Unstable,Growth,588,367236,494656
9595,1692221,752349,91,0,Low Volume,Growth,578,338444,413905
9596,1398610,318075,88,0,High Volume,Declining,568,279722,38353
9597,4585884,1671688,83,1,High Volume,Stable,544,917176,754512
9598,843389,75513,86,0,Stable,Growth,606,75513,0
9599,2613841,968803,97,0,Unstable,Growth,565,522768,446035
9600,1458114,711248,90,0,Low Volume,Growth,574,291622,419626
9601,1077650,314533,93,2,High Volume,Declining,483,215530,99003
9602,15693860,4305149,88,0,High Volume,Growth,663,4305149,0
9603,2772446,372321,88,0,Stable,Stable,556,372321,0
9604,3238473,1085551,92,0,High Volume,Growth,664,971541,114010
9605,4926904,1555408,91,0,High Volume,Growth,666,1478071,77337
9606,635979,218376,94,0,High Volume,Stable,624,190793,27583
9607,8055241,497310,85,2,Low Volume,Growth,507,497310,0
9608,500000,148463,98,0,High Volume,Growth,696,148463,0
9609,1071947,340580,89,0,Stable,Stable,576,214389,126191
9610,1373365,196925,96,0,Low Volume,Growth,605,196925,0
9611,3157776,453930,96,0,High Volume,Stable,635,453930,0
9612,2361895,411674,85,0,Low Volume,Stable,540,411674,0
9613,1735052,642446,97,1,High Volume,Stable,594,347010,295436
9614,1963820,633960,92,0,Stable,Growth,617,589146,44814
9615,906713,390424,99,1,High Volume,Growth,675,272013,118411
9616,598519,109557,97,0,Low Volume,Stable,567,109557,0
9617,3545569,1632489,96,0,Stable,Declining,546,709113,923376
9618,3453728,1328538,96,0,Stable,Stable,574,690745,637793
9619,7043357,1604162,91,0,Stable,Stable,567,1408671,195491
9620,1053877,97871,94,0,High Volume,Growth,680,97871,0
9621,3451268,571677,93,0,Stable,Growth,617,571677,0
9622,1580157,759338,90,0,Low Volume,Declining,489,316031,443307
9623,5139056,974691,91,1,High Volume,Stable,584,974691,0
9624,4490929,891249,88,0,Low Volume,Growth,599,891249,0
9625,2347749,317686,95,1,Stable,Declining,506,317686,0
9626,1511141,624226,82,0,Stable,Declining,478,302228,321998
9627,4276929,744356,87,0,High Volume,Stable,608,744356,0
9628,3326807,660758,93,0,High Volume,Growth,674,660758,0
9629,1146756,271158,92,0,Stable,Growth,608,271158,0
9630,685402,168045,88,0,Unstable,Declining,445,137080,30965
9631,1574068,370069,95,1,High Volume,Growth,648,370069,0
9632,6664670,1844012,90,0,High Volume,Declining,560,1332934,511078
9633,4961356,2066558,82,0,Stable,Declining,498,992271,1074287
9634,814344,340948,82,0,High Volume,Growth,658,244303,96645
9635,779022,318808,96,0,Stable,Stable,571,155804,163004
9636,5497187,525015,91,0,Stable,Growth,616,525015,0
9637,799300,327597,96,0,High Volume,Stable,655,239790,87807
9638,2980007,310258,92,0,Low Volume,Growth,584,310258,0
9639,1211225,128542,93,2,Unstable,Stable,452,128542,0
9640,7229178,3444980,96,1,Unstable,Growth,557,1445835,1999145
9641,1070525,448260,92,0,Stable,Growth,638,321157,127103
9642,4948966,1477686,93,0,Stable,Stable,577,989793,487893
9643,2298775,1020051,99,0,Low Volume,Growth,633,689632,330419
9644,2426004,1201391,86,0,Low Volume,Stable,510,485200,716191
9645,500000,162394,95,0,Stable,Stable,601,150000,12394
9646,500000,162902,96,0,Stable,Stable,605,150000,12902
9647,1662025,647346,87,0,Low Volume,Stable,537,332405,314941
9648,2415761,373145,95,0,High Volume,Declining,604,373145,0
9649,806002,100916,94,0,High Volume,Stable,617,100916,0
9650,829887,325159,91,0,Stable,Growth,634,248966,76193
9651,3107031,637585,86,0,Stable,Growth,605,637585,0
9652,3110467,344583,86,1,Stable,Stable,529,344583,0
9653,1775881,340427,96,0,Stable,Growth,637,340427,0
9654,3701177,782379,99,0,Stable,Growth,662,782379,0
9655,775015,375380,88,0,Stable,Growth,608,232504,142876
9656,1491439,543006,85,0,High Volume,Stable,607,447431,95575
9657,7409712,2140557,96,0,High Volume,Declining,581,1481942,658615
9658,2094149,1017742,90,1,Stable,Growth,580,418829,598913
9659,2193590,1001183,98,1,Unstable,Declining,426,438718,562465
9660,12544053,3517357,95,0,Stable,Growth,621,3517357,0
9661,647275,296164,96,0,Stable,Stable,584,129455,166709
9662,3749542,869658,80,1,Stable,Growth,533,749908,119750
9663,7505818,1153564,85,2,Low Volume,Growth,509,1153564,0
9664,1528983,236542,98,0,Stable,Growth,629,236542,0
9665,3943995,1372676,89,0,High Volume,Growth,678,1183198,189478
9666,903819,248986,95,0,Stable,Growth,649,248986,0
9667,1144655,396655,93,0,Stable,Stable,580,228931,167724
9668,2697870,967818,90,0,Low Volume,Growth,577,539574,428244
9669,3755956,225527,82,0,Stable,Declining,502,225527,0
9670,4860973,361257,84,0,High Volume,Stable,609,361257,0
9671,6960089,2016372,97,0,Stable,Growth,622,2016372,0
9672,1878610,255427,97,0,High Volume,Stable,622,255427,0
9673,5151968,1724056,93,0,Low Volume,Stable,555,1030393,693663
9674,1507791,450051,94,1,Stable,Stable,528,301558,148493
9675,4080267,1279540,95,0,Stable,Stable,576,816053,463487
9676,2340771,435629,96,0,Stable,Declining,525,435629,0
9677,2832138,957063,92,0,Stable,Declining,514,566427,390636
9678,2782350,1177690,88,1,Low Volume,Declining,445,556470,621220
9679,549210,274128,84,0,High Volume,Declining,549,109842,164286
9680,806696,344701,96,1,High Volume,Stable,616,242008,102693
9681,2152269,647563,95,0,Stable,Growth,642,645680,1883
9682,514102,70454,90,0,Low Volume,Growth,607,70454,0
9683,3855337,1375008,92,0,Stable,Stable,589,771067,603941
9684,3981801,1879188,92,0,Low Volume,Declining,481,796360,1082828
9685,2575969,374391,96,0,Low Volume,Growth,618,374391,0
9686,808627,133584,85,0,High Volume,Declining,549,133584,0
9687,5981077,700108,90,0,Stable,Declining,503,700108,0
9688,10117413,3860043,91,0,Low Volume,Growth,577,2023482,1836561
9689,2230333,519562,98,0,Stable,Stable,596,446066,73496
9690,2982965,233307,85,0,Stable,Declining,497,233307,0
9691,2330028,1033897,94,1,Low Volume,Declining,468,466005,567892
9692,3030673,912088,86,0,Low Volume,Growth,588,606134,305954
9693,1801901,358565,91,0,Stable,Declining,521,358565,0
9694,1928684,394980,96,1,High Volume,Growth,657,394980,0
9695,4092121,739090,91,0,Stable,Growth,641,739090,0
9696,12948614,3301457,92,0,High Volume,Growth,685,3301457,0
9697,646897,130459,91,1,High Volume,Growth,617,130459,0
9698,1824744,541175,90,0,Stable,Declining,510,364948,176227
9699,771145,306980,96,0,Stable,Growth,627,231343,75637
9700,7085917,2504925,97,0,Low Volume,Growth,631,2125775,379150
9701,1238993,226123,92,1,Stable,Growth,566,226123,0
9702,624958,179946,88,1,Low Volume,Growth,538,124991,54955
9703,3303687,1414166,94,1,Stable,Declining,492,660737,753429
9704,8003975,645863,95,0,Stable,Stable,586,645863,0
9705,3371534,287369,93,0,High Volume,Stable,640,287369,0
9706,2335738,701367,97,0,Stable,Growth,646,700721,646
9707,2750554,928592,89,0,High Volume,Growth,659,825166,103426
9708,6149446,892505,94,1,Low Volume,Declining,446,892505,0
9709,985240,379661,94,1,Low Volume,Declining,455,197048,182613
9710,1813052,617922,79,0,High Volume,Growth,620,543915,74007
9711,1380350,642526,89,0,Stable,Stable,587,276070,366456
9712,778954,98171,85,1,High Volume,Growth,634,98171,0
9713,1524687,591759,90,0,Stable,Stable,557,304937,286822
9714,4809852,421532,98,2,Unstable,Growth,492,421532,0
9715,3119807,949612,94,1,Low Volume,Stable,522,623961,325651
9716,3319911,990505,94,0,High Volume,Growth,664,990505,0
9717,2229261,501078,86,0,High Volume,Declining,564,445852,55226
9718,3013639,1296037,86,1,Low Volume,Growth,526,602727,693310
9719,1045000,54305,91,1,Stable,Growth,591,54305,0
9720,1547873,439721,94,3,Stable,Growth,525,309574,130147
9721,2311953,341520,93,0,Low Volume,Growth,607,341520,0
9722,2475648,952071,90,0,High Volume,Declining,559,495129,456942
9723,2561620,177726,99,0,High Volume,Growth,689,177726,0
9724,1775037,752970,89,2,Stable,Declining,417,355007,397963
9725,1466019,626198,90,0,High Volume,Declining,589,293203,332995
9726,24796598,10533340,97,0,Stable,Declining,534,4959319,5574021
9727,4095625,485970,91,0,Stable,Declining,534,485970,0
9728,2759384,920759,85,0,High Volume,Stable,600,827815,92944
9729,1645300,92902,87,0,High Volume,Stable,616,92902,0
9730,1381976,596438,95,0,Low Volume,Stable,567,276395,320043
9731,1785769,670268,94,0,Low Volume,Growth,612,535730,134538
9732,2506162,724329,90,1,Stable,Stable,517,501232,223097
9733,500000,189383,97,0,High Volume,Growth,695,150000,39383
9734,564948,52227,87,0,Stable,Declining,523,52227,0
9735,1191227,342948,86,0,High Volume,Declining,567,238245,104703
9736,2340117,423735,81,1,Low Volume,Growth,503,423735,0
9737,1637337,798494,93,1,Stable,Stable,519,327467,471027
9738,6468773,2818464,93,0,High Volume,Stable,635,1940631,877833
9739,605665,230137,89,1,High Volume,Growth,610,181699,48438
9740,1086991,511088,98,0,Unstable,Growth,600,326097,184991
9741,6689659,1378601,92,0,High Volume,Growth,679,1378601,0
9742,2202042,1002801,91,0,Low Volume,Stable,546,440408,562393
9743,4024350,790210,97,0,Unstable,Stable,516,790210,0
9744,10231662,3885561,85,0,Stable,Growth,623,3069498,816063
9745,1138198,434095,87,0,Stable,Stable,541,227639,206456
9746,1831322,106688,87,1,Stable,Declining,479,106688,0
9747,1594480,338790,96,0,Stable,Declining,541,318896,19894
9748,500000,29372,99,1,High Volume,Stable,599,29372,0
9749,1546775,771363,87,0,Stable,Stable,568,309355,462008
9750,4012198,421235,95,0,High Volume,Stable,629,421235,0
9751,3055554,899142,92,0,High Volume,Growth,686,899142,0
9752,3253580,1320141,87,1,Stable,Growth,572,650716,669425
9753,1468266,206392,97,0,Stable,Growth,632,206392,0
9754,1173055,314700,89,2,High Volume,Growth,583,234611,80089
9755,5473367,1769775,99,1,Unstable,Growth,552,1094673,675102
9756,1331939,162619,86,0,High Volume,Stable,600,162619,0
9757,2508676,1004348,96,1,Unstable,Stable,508,501735,502613
9758,2259531,417339,96,0,High Volume,Growth,684,417339,0
9759,6384435,925490,85,0,High Volume,Growth,660,925490,0
9760,4312938,1299186,90,0,High Volume,Growth,677,1293881,5305
9761,703479,165065,79,0,Stable,Growth,604,165065,0
9762,766782,355886,83,0,Stable,Growth,610,230034,125852
9763,3150677,1405291,94,1,Unstable,Growth,532,630135,775156
9764,1883288,503794,94,0,Low Volume,Growth,590,376657,127137
9765,1377613,291598,94,1,High Volume,Growth,658,291598,0
9766,4468227,877931,94,0,High Volume,Stable,627,877931,0
9767,2303563,392535,90,0,High Volume,Growth,654,392535,0
9768,2067738,610079,90,0,Stable,Stable,587,413547,196532
9769,3700072,1525319,91,0,High Volume,Stable,611,1110021,415298
9770,1468736,278826,92,0,High Volume,Growth,661,278826,0
9771,6953914,942550,89,0,Stable,Stable,561,942550,0
9772,1055539,278628,84,0,High Volume,Growth,649,278628,0
9773,3353594,271861,87,0,High Volume,Growth,645,271861,0
9774,6243592,2282505,85,1,High Volume,Stable,585,1248718,1033787
9775,658792,186610,87,0,Stable,Growth,600,186610,0
9776,1506549,411843,87,0,High Volume,Growth,656,411843,0
9777,4944399,915705,96,0,Low Volume,Stable,564,915705,0
9778,5004238,2287452,96,0,Low Volume,Declining,527,1000847,1286605
9779,1728567,156814,95,0,Stable,Stable,587,156814,0
9780,1101588,486264,94,2,Low Volume,Growth,529,220317,265947
9781,4259868,935115,96,0,High Volume,Growth,678,935115,0
9782,5110661,2280789,90,0,Unstable,Growth,543,1022132,1258657
9783,780952,295155,93,1,Stable,Growth,572,156190,138965
9784,756811,73317,97,0,Stable,Declining,536,73317,0
9785,2374281,1007149,95,0,Stable,Growth,642,712284,294865
9786,3280441,1171050,98,0,Stable,Stable,602,984132,186918
9787,1560856,100731,95,0,Stable,Stable,581,100731,0
9788,3414136,376122,84,0,Stable,Growth,587,376122,0
9789,1123423,377507,90,1,Stable,Stable,527,224684,152823
9790,500000,174085,86,0,High Volume,Stable,600,150000,24085
9791,1412510,545219,90,0,Stable,Growth,634,423753,121466
9792,2085639,780259,95,0,High Volume,Stable,639,625691,154568
9793,1590133,551433,89,0,Unstable,Declining,471,318026,233407
9794,784748,309824,94,2,Low Volume,Stable,462,156949,152875
9795,500000,154394,98,0,Stable,Stable,585,100000,54394
9796,1314187,219937,95,0,Stable,Stable,602,219937,0
9797,4065814,1872590,90,1,Low Volume,Stable,511,813162,1059428
9798,5416487,315220,80,0,Stable,Growth,583,315220,0
9799,5127715,1102217,96,0,Stable,Declining,542,1025543,76674
9800,1032272,390190,95,1,Stable,Declining,507,206454,183736
9801,787828,190828,83,0,Low Volume,Stable,532,157565,33263
9802,2949976,180466,99,0,High Volume,Declining,615,180466,0
9803,3295538,262626,89,0,Low Volume,Stable,552,262626,0
9804,2730883,933653,94,0,Stable,Growth,617,819264,114389
9805,500000,242095,97,0,Stable,Growth,661,150000,92095
9806,991022,295660,96,0,Unstable,Stable,511,198204,97456
9807,1936222,538349,82,1,Stable,Declining,442,387244,151105
9808,2927837,565794,90,0,Stable,Stable,584,565794,0
9809,3663194,606298,95,0,Stable,Stable,583,606298,0
9810,2225301,132279,96,0,Unstable,Growth,588,132279,0
9811,2583426,446493,95,0,Stable,Stable,584,446493,0
9812,2122048,534968,98,1,High Volume,Stable,604,534968,0
9813,3431457,477238,96,0,Stable,Declining,542,477238,0
9814,2546658,227433,100,0,Unstable,Growth,581,227433,0
9815,2089823,779457,84,0,Stable,Stable,565,417964,361493
9816,1599665,723975,90,0,High Volume,Growth,666,479899,244076
9817,2115990,997790,86,1,Stable,Growth,579,423198,574592
9818,2921691,958605,95,1,Stable,Growth,575,584338,374267
9819,2455842,181115,99,0,Stable,Declining,541,181115,0
9820,2688949,1030911,84,1,High Volume,Growth,592,537789,493122
9821,5804694,577816,89,0,Stable,Growth,621,577816,0
9822,2451305,861356,88,1,Stable,Growth,560,490261,371095
9823,1179736,472737,87,0,High Volume,Stable,624,353920,118817
9824,4020374,1514230,90,1,High Volume,Growth,615,1206112,308118
9825,664667,317942,97,0,Low Volume,Growth,628,199400,118542
9826,834735,319007,94,0,Unstable,Growth,587,166947,152060
9827,2593912,938852,85,0,Unstable,Stable,475,518782,420070
9828,2996985,502847,98,0,Unstable,Declining,478,502847,0
9829,732310,341363,93,0,Unstable,Stable,511,146462,194901
9830,1459707,190922,90,1,Low Volume,Declining,450,190922,0
9831,1220942,558219,82,1,Low Volume,Declining,418,244188,314031
9832,1343326,256170,88,0,High Volume,Growth,683,256170,0
9833,4218028,457967,97,0,Stable,Declining,537,457967,0
9834,3489274,1472499,98,0,Stable,Growth,640,1046782,425717
9835,1952658,99826,96,1,Low Volume,Stable,509,99826,0
9836,1281101,543750,89,0,Stable,Stable,580,256220,287530
9837,673525,113179,96,0,Stable,Stable,606,113179,0
9838,6175794,2767525,85,0,Low Volume,Stable,544,1235158,1532367
9839,3184135,1150000,84,0,Low Volume,Growth,562,636827,513173
9840,1126544,394045,91,2,Stable,Declining,436,225308,168737
9841,3526017,755956,92,0,Stable,Growth,620,755956,0
9842,1874441,143828,95,0,Low Volume,Declining,507,143828,0
9843,1575861,667429,93,0,Low Volume,Declining,482,315172,352257
9844,2808523,356420,98,0,Stable,Stable,606,356420,0
9845,1095588,238308,84,2,Low Volume,Stable,446,219117,19191
9846,1506041,482173,87,2,High Volume,Declining,501,301208,180965
9847,2185093,583451,93,0,Stable,Growth,630,583451,0
9848,1329667,185352,82,0,High Volume,Stable,607,185352,0
9849,3386367,383599,93,0,High Volume,Growth,659,383599,0
9850,8844030,932699,89,0,Low Volume,Growth,590,932699,0
9851,1084426,475362,93,0,Stable,Growth,615,325327,150035
9852,523295,33596,91,0,Stable,Stable,589,33596,0
9853,500000,244828,77,1,Stable,Growth,526,100000,144828
9854,1757891,244941,95,0,Stable,Stable,579,244941,0
9855,1166442,116230,96,2,Stable,Growth,571,116230,0
9856,2341467,725005,94,0,Stable,Growth,612,702440,22565
9857,2204647,189586,90,0,Low Volume,Stable,558,189586,0
9858,549864,176564,88,0,High Volume,Stable,601,164959,11605
9859,500000,216391,82,0,High Volume,Declining,560,100000,116391
9860,2512394,179772,92,0,Stable,Stable,567,179772,0
9861,2209646,905824,97,1,Stable,Growth,604,662893,242931
9862,1410346,320875,96,0,High Volume,Declining,568,282069,38806
9863,526647,64130,92,0,Stable,Growth,618,64130,0
9864,2891000,373643,90,0,Low Volume,Declining,506,373643,0
9865,5484956,2541970,99,0,Low Volume,Growth,611,1645486,896484
9866,2476572,247094,95,0,Stable,Stable,598,247094,0
9867,1006532,442927,86,0,High Volume,Growth,674,301959,140968
9868,2054703,605953,95,0,Stable,Growth,627,605953,0
9869,664712,44918,95,0,Stable,Declining,530,44918,0
9870,4622141,1197200,97,0,Low Volume,Growth,626,1197200,0
9871,2116926,884562,95,0,Stable,Stable,570,423385,461177
9872,500000,188396,78,0,Low Volume,Growth,567,100000,88396
9873,1558852,420815,91,0,Unstable,Stable,504,311770,109045
9874,2872350,1255281,92,0,Stable,Growth,643,861705,393576
9875,1518999,158225,94,1,High Volume,Stable,607,158225,0
9876,1590062,730591,95,0,High Volume,Growth,688,477018,253573
9877,744508,320807,94,0,High Volume,Growth,665,223352,97455
9878,3119654,1150293,91,0,High Volume,Growth,677,935896,214397
9879,1180236,493397,97,0,High Volume,Growth,711,472094,21303
9880,500000,147358,98,0,High Volume,Stable,634,147358,0
9881,1473269,521277,94,0,Stable,Growth,614,441980,79297
9882,4346666,1313863,98,1,High Volume,Stable,590,869333,444530
9883,1454913,305449,92,0,Stable,Stable,566,290982,14467
9884,7963570,2436752,91,3,High Volume,Growth,533,1592714,844038
9885,2794530,463499,88,0,High Volume,Growth,684,463499,0
9886,2599960,645117,79,0,High Volume,Stable,607,645117,0
9887,1789204,315524,86,1,Low Volume,Growth,543,315524,0
9888,1877349,197684,87,0,Stable,Growth,604,197684,0
9889,1606006,312911,92,0,Stable,Stable,571,312911,0
9890,1556865,674736,90,1,Low Volume,Stable,491,311373,363363
9891,3031881,671520,86,0,Low Volume,Stable,536,606376,65144
9892,937840,362570,96,0,Stable,Growth,649,281352,81218
9893,838429,108022,90,1,Stable,Growth,569,108022,0
9894,807295,194549,83,0,Low Volume,Declining,477,161459,33090
9895,10185988,1035765,91,1,High Volume,Stable,600,1035765,0
9896,3030610,340578,95,0,Low Volume,Declining,503,340578,0
9897,2529656,829339,94,0,Stable,Growth,620,758896,70443
9898,850848,275136,87,0,Stable,Stable,565,170169,104967
9899,3264685,476701,92,1,Stable,Growth,584,476701,0
9900,1806213,475920,90,0,Unstable,Declining,478,361242,114678
9901,2353314,1031899,90,0,Unstable,Stable,498,470662,561237
9902,907731,116544,95,0,Stable,Stable,581,116544,0
9903,2253996,132185,86,0,Stable,Declining,514,132185,0
9904,1412587,485079,95,0,Low Volume,Growth,592,282517,202562
9905,1074656,79604,88,0,Stable,Stable,566,79604,0
9906,3567177,1751388,90,1,Stable,Growth,572,713435,1037953
9907,579449,187932,92,0,High Volume,Growth,696,173834,14098
9908,3115253,815194,84,0,Unstable,Growth,529,623050,192144
9909,3428347,834791,88,0,High Volume,Growth,656,834791,0
9910,980958,302019,84,0,Stable,Stable,544,196191,105828
9911,1028629,93380,99,0,Stable,Growth,643,93380,0
9912,1658758,777142,93,1,High Volume,Growth,638,497627,279515
9913,2484617,823747,94,0,High Volume,Declining,566,496923,326824
9914,1754538,232986,84,0,Unstable,Growth,546,232986,0
9915,2804820,850313,95,0,Low Volume,Growth,600,841446,8867
9916,8124410,893404,96,1,High Volume,Declining,545,893404,0
9917,1320904,76479,92,1,Stable,Growth,574,76479,0
9918,502754,167785,89,0,High Volume,Declining,581,100550,67235
9919,3839063,1312259,92,0,Low Volume,Growth,585,767812,544447
9920,7622780,2383365,93,0,Stable,Declining,543,1524556,858809
9921,2714762,359889,93,1,Unstable,Declining,445,359889,0
9922,830515,267047,95,0,Stable,Declining,533,166103,100944
9923,1795665,135447,90,0,Low Volume,Growth,582,135447,0
9924,810317,262670,97,0,High Volume,Stable,656,243095,19575
9925,3316048,992519,92,2,Unstable,Declining,390,663209,329310
9926,672641,231970,94,0,Stable,Growth,616,201792,30178
9927,1559533,706412,76,1,Stable,Growth,534,311906,394506
9928,887825,384127,90,0,High Volume,Growth,683,266347,117780
9929,2194489,1078140,95,0,Stable,Stable,587,438897,639243
9930,1479074,723723,84,0,Low Volume,Growth,554,295814,427909
9931,2283933,907964,92,0,High Volume,Stable,615,685179,222785
9932,2018531,969680,99,0,High Volume,Growth,708,807412,162268
9933,900471,396457,94,0,Stable,Growth,644,270141,126316
9934,3273930,1235621,97,1,Low Volume,Stable,507,654786,580835
9935,1906896,160032,91,0,Unstable,Growth,555,160032,0
9936,899125,64802,91,0,Low Volume,Stable,560,64802,0
9937,11908241,5083864,96,0,High Volume,Declining,578,2381648,2702216
9938,2902677,784725,92,0,Unstable,Stable,510,580535,204190
9939,1753969,730656,90,0,High Volume,Growth,672,526190,204466
9940,6151236,1173737,97,0,Low Volume,Declining,509,1173737,0
9941,8653310,1981110,89,0,Stable,Stable,554,1730662,250448
9942,1765105,644412,97,0,Low Volume,Stable,564,353021,291391
9943,2617992,1209243,98,0,High Volume,Growth,675,785397,423846
9944,899503,80499,91,1,High Volume,Growth,650,80499,0
9945,1762503,771386,97,0,Stable,Growth,650,528750,242636
9946,1690864,687938,95,1,High Volume,Declining,557,338172,349766
9947,2298717,441337,90,0,Stable,Growth,618,441337,0
9948,2587515,542983,98,0,Low Volume,Growth,624,542983,0
9949,3102947,220023,98,0,Stable,Stable,597,220023,0
9950,2397924,136881,91,1,Stable,Growth,584,136881,0
9951,752688,199201,93,0,High Volume,Declining,597,150537,48664
9952,935865,87029,81,0,High Volume,Declining,551,87029,0
9953,1280644,175833,90,1,Low Volume,Growth,563,175833,0
9954,1582011,681918,94,0,Stable,Stable,565,316402,365516
9955,4595644,1410692,91,0,Stable,Growth,619,1378693,31999
9956,782030,262085,96,0,High Volume,Stable,645,234609,27476
9957,1489674,200161,96,1,Stable,Stable,565,200161,0
9958,4249907,1797276,82,0,Stable,Growth,579,849981,947295
9959,1559847,687254,90,0,Stable,Stable,565,311969,375285
9960,2865727,818158,96,0,Low Volume,Growth,623,818158,0
9961,1773324,816883,89,0,Low Volume,Stable,547,354664,462219
9962,2434925,1047439,82,0,Low Volume,Declining,460,486985,560454
9963,1651545,626094,92,0,Stable,Growth,614,495463,130631
9964,3380900,1285872,98,1,Unstable,Growth,559,676180,609692
9965,576053,56123,97,1,Stable,Growth,584,56123,0
9966,1482663,254835,94,0,Stable,Growth,630,254835,0
9967,2513679,201299,93,1,Stable,Declining,502,201299,0
9968,3038748,163808,98,0,Low Volume,Stable,567,163808,0
9969,6545983,793630,96,0,Stable,Growth,628,793630,0
9970,1450154,647087,86,0,Stable,Declining,522,290030,357057
9971,6475817,1022812,80,1,Stable,Stable,507,1022812,0
9972,1170312,569438,92,1,High Volume,Declining,543,234062,335376
9973,5739698,1829706,83,0,Low Volume,Stable,509,1147939,681767
9974,3813179,597778,93,1,Low Volume,Declining,476,597778,0
9975,954777,261331,95,1,Low Volume,Stable,528,190955,70376
9976,2534815,376655,94,0,Stable,Declining,526,376655,0
9977,1903132,937841,87,0,Stable,Stable,548,380626,557215
9978,3270547,1410486,84,0,High Volume,Stable,622,981164,429322
9979,1658431,102503,86,0,High Volume,Growth,674,102503,0
9980,1550678,738897,90,0,Stable,Declining,540,310135,428762
9981,5928464,2220087,89,1,High Volume,Growth,607,1778539,441548
9982,1832191,159532,96,0,High Volume,Stable,641,159532,0
9983,3840595,1351071,82,0,High Volume,Growth,635,1152178,198893
9984,1655674,564779,96,1,Stable,Declining,517,331134,233645
9985,7521910,1116665,82,0,Stable,Growth,592,1116665,0
9986,1152371,450924,90,0,Stable,Declining,513,230474,220450
9987,1213095,108183,99,2,Unstable,Stable,437,108183,0
9988,6713384,1814294,85,0,Unstable,Declining,435,1342676,471618
9989,1388928,75649,91,0,High Volume,Stable,643,75649,0
9990,7137402,3468291,93,0,Unstable,Growth,551,1427480,2040811
9991,4046944,1571038,90,0,High Volume,Growth,666,1214083,356955
9992,1752020,212841,93,0,Stable,Growth,619,212841,0
9993,500000,101877,88,0,Low Volume,Growth,587,100000,1877
9994,1952352,238681,97,0,Stable,Growth,656,238681,0
9995,2150700,849479,97,0,High Volume,Stable,653,645210,204269
9996,5044324,385908,95,0,Low Volume,Growth,616,385908,0
9997,7065665,3025398,97,0,Stable,Growth,645,2119699,905699
9998,1146255,543312,96,0,Unstable,Declining,484,229251,314061
9999,3763822,1334209,92,0,Unstable,Growth,562,752764,581445
10000,3657615,533406,95,0,Unstable,Growth,571,533406,0
10001,4679633,992272,87,0,Stable,Growth,630,992272,0
10002,2954831,782315,89,0,Low Volume,Stable,520,590966,191349
10003,500000,161041,98,0,Unstable,Declining,481,100000,61041
10004,1750938,614401,94,0,High Volume,Declining,572,350187,264214
10005,786568,235496,95,0,Low Volume,Declining,525,157313,78183
10006,1686077,350858,95,0,High Volume,Growth,704,350858,0
10007,4342685,1958172,94,0,Unstable,Stable,513,868537,1089635
10008,2530989,219251,94,0,High Volume,Stable,648,219251,0
10009,4967726,1290691,81,0,Stable,Declining,482,993545,297146
10010,2606198,1039884,89,0,Stable,Stable,561,521239,518645
10011,701755,54311,96,0,Stable,Growth,628,54311,0
10012,500000,183700,93,1,Low Volume,Stable,522,100000,83700
10013,2233425,935515,96,0,High Volume,Growth,702,893370,42145
10014,1670876,580419,91,0,High Volume,Growth,660,501262,79157
10015,907495,50658,92,0,High Volume,Growth,686,50658,0
10016,508641,66663,83,1,Low Volume,Growth,523,66663,0
10017,1101524,224657,86,1,High Volume,Stable,576,220304,4353
10018,1697058,263316,93,0,Low Volume,Stable,543,263316,0
10019,3377689,1632077,96,1,High Volume,Declining,558,675537,956540
10020,2305723,791364,93,0,Stable,Stable,565,461144,330220
10021,7177443,1318044,99,0,Stable,Growth,656,1318044,0
10022,865893,405553,84,0,Low Volume,Stable,526,173178,232375
10023,4012187,1537740,93,0,High Volume,Growth,673,1203656,334084
10024,2059222,366692,80,0,Low Volume,Growth,552,366692,0
10025,3456390,762123,90,1,Low Volume,Growth,539,691278,70845
10026,1398328,195407,93,0,Stable,Stable,577,195407,0
10027,4673152,2275747,86,1,High Volume,Declining,512,934630,1341117
10028,2510970,710061,81,1,Stable,Stable,485,502194,207867
10029,1151348,521820,93,0,Unstable,Growth,566,230269,291551
10030,1963778,404391,88,1,High Volume,Growth,625,404391,0
10031,1636966,715974,97,0,Low Volume,Declining,527,327393,388581
10032,2932432,217730,92,0,Stable,Stable,587,217730,0
10033,771567,379565,92,0,High Volume,Stable,636,231470,148095
10034,1936744,891707,86,1,Stable,Declining,457,387348,504359
10035,2720281,580620,82,0,Stable,Declining,516,544056,36564
10036,2035839,811536,91,1,Stable,Growth,583,407167,404369
10037,5824321,2262842,92,1,Unstable,Growth,539,1164864,1097978
10038,3682926,1677811,89,0,Low Volume,Growth,595,736585,941226
10039,1970929,371056,91,0,Stable,Declining,512,371056,0
10040,2358063,611880,92,0,High Volume,Growth,683,611880,0
10041,2511856,1103332,79,1,High Volume,Growth,586,502371,600961
10042,2737730,1096080,90,0,Unstable,Stable,521,547546,548534
10043,500000,113530,94,0,Unstable,Declining,465,100000,13530
10044,1557790,670748,87,0,Low Volume,Growth,592,311558,359190
10045,604676,43010,90,0,Unstable,Stable,519,43010,0
10046,5513029,2215801,97,0,High Volume,Declining,578,1102605,1113196
10047,1888551,270147,92,0,Low Volume,Stable,562,270147,0
10048,1698621,303636,92,0,Stable,Stable,574,303636,0
10049,4063023,1104926,84,1,Low Volume,Stable,483,812604,292322
10050,2779717,701546,94,0,Stable,Declining,535,555943,145603
10051,803789,228482,93,0,Low Volume,Growth,606,228482,0
10052,1873419,552938,99,1,Stable,Stable,577,374683,178255
10053,1516425,302053,85,0,Unstable,Growth,529,302053,0
10054,500000,64426,95,1,High Volume,Stable,583,64426,0
10055,1141415,451791,95,1,Stable,Declining,482,228283,223508
10056,1711991,393740,97,0,Low Volume,Stable,558,342398,51342
10057,1808556,502106,91,0,Stable,Growth,642,502106,0
10058,605745,206022,87,0,High Volume,Stable,603,181723,24299
10059,4981953,2288396,90,0,Stable,Growth,605,1494585,793811
10060,1827241,673153,95,0,Stable,Stable,580,365448,307705
10061,2043230,143959,86,0,High Volume,Growth,655,143959,0
10062,2731915,1167490,96,1,Low Volume,Stable,514,546383,621107
10063,1055515,522701,93,0,High Volume,Growth,660,316654,206047
10064,2856435,750152,87,0,Low Volume,Growth,578,571287,178865
10065,1478207,718875,92,0,High Volume,Growth,666,443462,275413
10066,967752,286743,83,0,Stable,Stable,530,193550,93193
10067,3136939,805651,94,2,Stable,Growth,533,627387,178264
10068,6539290,1302183,88,0,Unstable,Stable,501,1302183,0
10069,3540801,1224762,93,0,High Volume,Growth,699,1062240,162522
10070,4149017,636539,93,0,Stable,Growth,630,636539,0
10071,1307327,127099,91,0,High Volume,Growth,668,127099,0
10072,552332,34386,95,0,Low Volume,Stable,561,34386,0
10073,6531257,1185887,82,0,Low Volume,Stable,512,1185887,0
10074,10258446,2339919,94,1,Low Volume,Growth,558,2051689,288230
10075,6812334,2033036,92,0,Unstable,Growth,551,1362466,670570
10076,1515675,275455,92,0,Stable,Growth,638,275455,0
10077,787243,387974,87,0,Stable,Growth,603,236172,151802
10078,845306,153242,94,0,Stable,Stable,567,153242,0
10079,515563,128086,94,0,Low Volume,Growth,607,128086,0
10080,1819545,175539,89,0,Stable,Stable,565,175539,0
10081,7163737,1198364,96,0,Stable,Growth,655,1198364,0
10082,1770318,127019,84,0,High Volume,Stable,600,127019,0
10083,2525269,762073,92,0,Low Volume,Declining,501,505053,257020
10084,5959383,2312116,94,1,Stable,Declining,493,1191876,1120240
10085,1435069,198139,95,0,Stable,Declining,525,198139,0
10086,10103830,2177981,89,0,Stable,Growth,618,2177981,0
10087,9758756,560907,95,2,High Volume,Growth,616,560907,0
10088,1785325,763735,95,1,Low Volume,Growth,551,357065,406670
10089,1249148,500888,94,1,Low Volume,Growth,563,249829,251059
10090,3463501,271761,85,0,Stable,Stable,540,271761,0
10091,1501507,321608,98,0,Unstable,Declining,478,300301,21307
10092,786034,377201,98,0,High Volume,Stable,661,235810,141391
10093,5526089,1251174,96,1,Stable,Stable,568,1105217,145957
10094,5246952,1504794,90,0,High Volume,Growth,667,1504794,0
10095,2245434,471225,93,0,Stable,Growth,643,471225,0
10096,721948,229767,95,0,Unstable,Growth,588,144389,85378
10097,741462,363443,90,0,Stable,Stable,578,148292,215151
10098,2160356,1077750,82,1,Stable,Stable,490,432071,645679
10099,1329220,529856,98,0,Stable,Growth,647,398766,131090
10100,1509253,350056,89,0,High Volume,Growth,678,350056,0
10101,4490931,1223754,89,0,Stable,Growth,626,1223754,0
10102,3564532,750438,98,0,Stable,Growth,628,750438,0
10103,5971532,2947002,95,0,Stable,Stable,598,1194306,1752696
10104,897619,330766,92,1,Stable,Growth,583,179523,151243
10105,1506722,379723,97,0,High Volume,Growth,706,379723,0
10106,3638876,201782,95,0,Stable,Growth,635,201782,0
10107,2837582,806491,93,0,Stable,Stable,580,567516,238975
10108,6755748,3329014,86,0,Stable,Growth,626,2026724,1302290
10109,2775744,792135,93,0,Stable,Growth,629,792135,0
10110,8696988,1148803,93,0,Unstable,Growth,583,1148803,0
10111,3054157,183073,93,0,Unstable,Growth,553,183073,0
10112,4637722,972144,93,1,Low Volume,Declining,471,927544,44600
10113,1530627,708990,97,1,High Volume,Growth,637,459188,249802
10114,2005552,999666,89,1,Low Volume,Stable,500,401110,598556
10115,4109268,1953610,87,1,Stable,Growth,589,821853,1131757
10116,7205697,2725476,92,0,Unstable,Growth,553,1441139,1284337
10117,3553308,1070129,85,0,Stable,Declining,499,710661,359468
10118,1855125,585865,85,0,High Volume,Declining,540,371025,214840
10119,5967675,1745822,94,1,Stable,Growth,576,1193535,552287
10120,500000,184086,94,1,Stable,Declining,494,100000,84086
10121,635529,151569,85,1,High Volume,Stable,564,127105,24464
10122,3420534,1201092,94,0,Low Volume,Declining,493,684106,516986
10123,2005265,210002,86,0,Stable,Growth,608,210002,0
10124,3218452,545730,89,0,High Volume,Stable,618,545730,0
10125,2087601,889738,93,1,Stable,Growth,593,417520,472218
10126,3130667,1429735,96,1,Stable,Declining,489,626133,803602
10127,1033517,302359,99,2,High Volume,Stable,548,206703,95656
10128,3129516,201028,93,1,High Volume,Growth,648,201028,0
10129,4393038,2052155,94,1,High Volume,Declining,528,878607,1173548
10130,5264204,1926324,92,1,Low Volume,Declining,472,1052840,873484
10131,9927740,2346050,91,0,Unstable,Growth,560,1985548,360502
10132,2410341,769551,94,0,Stable,Stable,579,482068,287483
10133,2468519,600834,87,0,Stable,Declining,518,493703,107131
10134,586227,152069,93,1,Low Volume,Growth,572,117245,34824
10135,1296101,582033,93,1,High Volume,Stable,576,259220,322813
10136,1698973,208104,95,0,High Volume,Growth,683,208104,0
10137,4593972,444012,91,0,Stable,Growth,608,444012,0
10138,1216148,62301,96,0,Low Volume,Stable,544,62301,0
10139,3749271,717236,90,0,Stable,Declining,519,717236,0
10140,1980189,230368,78,1,Unstable,Growth,487,230368,0
10141,1720741,256379,79,0,Stable,Growth,595,256379,0
10142,2419606,133218,87,0,Stable,Declining,518,133218,0
10143,1450001,220745,92,0,Unstable,Growth,550,220745,0
10144,1406718,280950,98,1,Low Volume,Declining,470,280950,0
10145,506952,32549,91,1,High Volume,Growth,648,32549,0
10146,1626005,526105,90,0,Stable,Stable,582,325201,200904
10147,1350554,413216,88,1,Low Volume,Growth,529,270110,143106
10148,1312199,122909,94,0,High Volume,Growth,699,122909,0
10149,2767620,879423,85,0,Low Volume,Stable,507,553524,325899
10150,3358166,1677049,96,0,Stable,Growth,627,1007449,669600
10151,2387496,1134087,88,0,High Volume,Growth,654,716248,417839
10152,4396556,225112,89,0,Stable,Growth,619,225112,0
10153,3142250,1281787,90,0,Stable,Growth,603,942675,339112
10154,1565875,327459,90,0,Stable,Growth,606,327459,0
10155,1369170,107676,93,2,Stable,Declining,454,107676,0
10156,2546570,466512,96,1,Low Volume,Growth,580,466512,0
10157,3137741,611174,90,1,Stable,Stable,550,611174,0
10158,6066397,1731713,89,1,Unstable,Growth,531,1213279,518434
10159,5141927,1786756,91,0,Stable,Declining,530,1028385,758371
10160,1285710,497666,96,0,Low Volume,Growth,628,385713,111953
10161,1827382,293581,89,0,High Volume,Growth,681,293581,0
10162,3391606,660674,90,0,Stable,Growth,638,660674,0
10163,4659405,879564,85,0,Stable,Stable,550,879564,0
10164,4202439,896093,89,2,High Volume,Growth,576,840487,55606
10165,1883981,941699,94,1,Stable,Stable,528,376796,564903
10166,727073,290883,99,0,Low Volume,Declining,503,145414,145469
10167,891670,435800,95,1,High Volume,Growth,649,267501,168299
10168,2465997,892444,94,1,Stable,Declining,476,493199,399245
10169,2607182,607009,95,0,Unstable,Growth,580,521436,85573
10170,823284,185556,98,0,Stable,Growth,653,185556,0
10171,2054731,554493,95,0,Stable,Growth,625,554493,0
10172,3285336,780568,93,0,Stable,Declining,515,657067,123501
10173,789392,333713,86,0,Stable,Growth,626,236817,96896
10174,4799382,1244244,99,0,High Volume,Growth,702,1244244,0
10175,1465893,268297,85,0,High Volume,Stable,620,268297,0
10176,5422625,2161931,90,0,Stable,Declining,521,1084525,1077406
10177,1293986,562223,84,0,Stable,Growth,593,258797,303426
10178,872135,208609,89,0,Stable,Stable,568,174427,34182
10179,1374349,481728,94,0,Unstable,Growth,553,274869,206859
10180,1837436,140494,93,0,Stable,Growth,648,140494,0
10181,1453109,418872,94,0,High Volume,Growth,673,418872,0
10182,1668105,117170,79,0,Stable,Growth,567,117170,0
10183,2590010,163523,81,0,Low Volume,Growth,557,163523,0
10184,1729005,563338,95,0,Stable,Growth,654,518701,44637
10185,1880616,350737,96,0,High Volume,Stable,624,350737,0
10186,505154,194051,82,0,Stable,Declining,513,101030,93021
10187,2712438,1229378,91,0,Stable,Growth,639,813731,415647
10188,1846195,208114,94,0,Stable,Growth,633,208114,0
10189,7190235,2703782,97,0,Stable,Growth,653,2157070,546712
10190,935043,263246,92,0,Stable,Declining,538,187008,76238
10191,500000,50227,86,1,Low Volume,Stable,496,50227,0
10192,3250940,1115777,78,1,Stable,Growth,542,650188,465589
10193,2616169,848319,98,0,Low Volume,Growth,598,523233,325086
10194,884921,249582,92,0,High Volume,Growth,669,249582,0
10195,583151,272280,84,0,High Volume,Stable,590,116630,155650
10196,6782914,1929643,98,0,Unstable,Growth,568,1356582,573061
10197,6145854,3046695,81,0,High Volume,Stable,607,1843756,1202939
10198,500000,139576,97,0,Stable,Stable,591,100000,39576
10199,1374254,140357,86,1,Unstable,Growth,515,140357,0
10200,7507054,1964687,96,1,Low Volume,Growth,549,1501410,463277
10201,1354780,178896,85,0,Unstable,Declining,430,178896,0
10202,1339103,426786,96,0,Unstable,Growth,588,267820,158966
10203,1581355,572307,98,1,Stable,Stable,565,316271,256036
10204,808780,210926,95,0,Stable,Growth,625,210926,0
10205,506956,47637,90,0,High Volume,Declining,563,47637,0
10206,4602167,1200653,98,0,High Volume,Stable,633,1200653,0
10207,500000,43327,98,1,Stable,Growth,622,43327,0
10208,2416467,862574,90,0,Stable,Stable,550,483293,379281
10209,4029946,1634811,91,0,Stable,Growth,633,1208983,425828
10210,620958,299967,92,0,Stable,Growth,613,186287,113680
10211,946556,110710,97,1,High Volume,Declining,532,110710,0
10212,5233252,1515493,96,0,High Volume,Growth,702,1515493,0
10213,3036795,927412,98,0,Low Volume,Growth,624,911038,16374
10214,1210049,562811,93,0,Low Volume,Stable,540,242009,320802
10215,5187691,1723737,95,1,Stable,Stable,555,1037538,686199
10216,5205512,601129,91,0,Stable,Growth,637,601129,0
10217,2458943,605781,86,0,High Volume,Declining,569,491788,113993
10218,964989,332577,96,0,Stable,Stable,584,192997,139580
10219,1424371,520078,94,0,High Volume,Growth,669,427311,92767
10220,2493279,1093012,94,0,High Volume,Growth,680,747983,345029
10221,1705083,223755,98,1,High Volume,Stable,619,223755,0
10222,4202397,2009561,95,0,Stable,Growth,625,1260719,748842
10223,583139,44676,96,1,Stable,Stable,532,44676,0
10224,599943,295588,77,2,Stable,Growth,508,119988,175600
10225,2291453,999062,97,0,Stable,Stable,572,458290,540772
10226,1338104,464486,93,0,High Volume,Declining,569,267620,196866
10227,1200635,457139,87,0,Stable,Declining,508,240127,217012
10228,500000,41356,97,0,Low Volume,Growth,595,41356,0
10229,2014007,138294,95,0,Unstable,Stable,523,138294,0
10230,1900820,182088,93,1,Stable,Declining,473,182088,0
10231,3344351,298690,97,1,Unstable,Growth,560,298690,0
10232,2095127,620831,89,0,Stable,Growth,615,620831,0
10233,1783194,262040,98,0,Stable,Growth,635,262040,0
10234,5083957,2222160,80,0,Low Volume,Growth,575,1016791,1205369
10235,693860,173872,89,1,Stable,Growth,584,138772,35100
10236,3045304,1105384,96,0,High Volume,Declining,602,913591,191793
10237,520780,179040,96,0,High Volume,Stable,655,156234,22806
10238,1013896,196629,89,1,Low Volume,Growth,549,196629,0
10239,751536,119814,94,0,Unstable,Growth,585,119814,0
10240,3706335,756483,87,0,High Volume,Declining,563,741267,15216
10241,1881673,768656,93,1,Stable,Stable,551,376334,392322
10242,1961456,615553,97,1,High Volume,Growth,643,588436,27117
10243,817997,134227,93,0,Low Volume,Declining,512,134227,0
10244,1560076,652160,89,0,Low Volume,Growth,595,312015,340145
10245,1076502,80352,83,3,Low Volume,Growth,458,80352,0
10246,2694610,982542,73,0,Low Volume,Growth,536,538922,443620
10247,897283,222163,88,0,Stable,Growth,628,222163,0
10248,5744971,2177807,89,1,High Volume,Stable,561,1148994,1028813
10249,518936,242529,89,0,Unstable,Growth,540,103787,138742
10250,1040055,403037,97,0,High Volume,Growth,675,312016,91021
10251,7585586,1887934,92,0,High Volume,Growth,694,1887934,0
10252,1399869,165099,91,0,Stable,Stable,567,165099,0
10253,692523,285914,83,2,Stable,Declining,407,138504,147410
10254,2362562,607929,95,0,High Volume,Growth,672,607929,0
10255,1355507,113714,92,0,Low Volume,Declining,485,113714,0
10256,1015919,379522,92,0,High Volume,Growth,677,304775,74747
10257,825136,149625,87,0,Stable,Growth,614,149625,0
10258,18159400,1307471,81,0,Stable,Growth,596,1307471,0
10259,1621332,739713,94,2,Low Volume,Declining,410,324266,415447
10260,500000,133698,95,0,High Volume,Stable,636,133698,0
10261,6549949,1155624,87,0,Low Volume,Stable,544,1155624,0
10262,3232792,1203808,93,1,High Volume,Growth,630,969837,233971
10263,1073921,481821,92,0,Stable,Growth,622,322176,159645
10264,939877,47124,95,1,Stable,Stable,528,47124,0
10265,3398274,1221793,89,0,Stable,Growth,626,1019482,202311
10266,1627353,643057,89,0,High Volume,Growth,682,488205,154852
10267,500000,72234,85,0,Stable,Growth,585,72234,0
10268,8283631,2239320,93,0,High Volume,Stable,641,2239320,0
10269,1401155,126354,96,0,High Volume,Growth,694,126354,0
10270,6559713,2532295,90,0,Stable,Growth,613,1967913,564382
10271,5513708,2378367,99,0,Stable,Growth,630,1654112,724255
10272,890192,87848,95,0,Stable,Stable,599,87848,0
10273,4531447,1891458,91,0,Stable,Growth,635,1359434,532024
10274,1177432,467684,84,0,High Volume,Declining,543,235486,232198
10275,500000,103055,96,0,High Volume,Growth,671,103055,0
10276,1411723,509110,91,1,Stable,Stable,546,282344,226766
10277,2725357,136327,82,0,Stable,Declining,489,136327,0
10278,1369301,642625,85,0,Stable,Stable,536,273860,368765
10279,1550924,461667,89,0,Low Volume,Growth,593,310184,151483
10280,4949776,1629231,90,0,High Volume,Growth,680,1484932,144299
10281,2159085,753730,89,0,Unstable,Declining,469,431817,321913
10282,1009899,305612,92,0,Low Volume,Stable,552,201979,103633
10283,3476805,1514301,92,1,Unstable,Growth,533,695361,818940
10284,2322467,753329,87,0,Stable,Stable,574,464493,288836
10285,500000,229246,97,0,Low Volume,Declining,520,100000,129246
10286,2793155,871602,95,0,Unstable,Growth,591,558631,312971
10287,2712722,344530,91,0,Stable,Stable,586,344530,0
10288,2014934,929092,91,0,Low Volume,Growth,573,402986,526106
10289,4046490,1443514,95,0,Unstable,Growth,567,809298,634216
10290,1157861,422223,93,0,Stable,Stable,576,231572,190651
10291,2595267,1280678,97,0,Stable,Growth,660,778580,502098
10292,566047,47457,95,1,Stable,Declining,475,47457,0
10293,2746045,666923,98,0,Stable,Stable,582,549209,117714
10294,9458721,1490628,96,2,Stable,Declining,443,1490628,0
10295,894585,298516,86,1,Stable,Growth,555,178917,119599
10296,1079662,445971,92,1,Stable,Growth,573,215932,230039
10297,1123532,544733,94,0,High Volume,Growth,685,337059,207674
10298,2200067,560067,93,0,Stable,Growth,633,560067,0
10299,847097,342056,97,0,Low Volume,Stable,566,169419,172637
10300,2777323,1284993,83,0,Stable,Growth,604,833196,451797
10301,3903843,1395610,94,1,Stable,Stable,560,780768,614842
10302,3040333,484111,87,0,High Volume,Stable,630,484111,0
10303,500000,161767,95,0,Low Volume,Growth,618,150000,11767
10304,4395686,2138406,94,1,Stable,Stable,529,879137,1259269
10305,4197056,2075021,98,0,Unstable,Growth,565,839411,1235610
10306,3852100,1306100,93,1,High Volume,Growth,636,1155630,150470
10307,2671829,1200037,95,2,High Volume,Stable,550,534365,665672
10308,2364676,331426,94,0,High Volume,Stable,639,331426,0
10309,4528546,727898,96,0,High Volume,Stable,625,727898,0
10310,9237767,4423038,96,0,Stable,Stable,585,1847553,2575485
10311,925017,102544,92,0,High Volume,Stable,644,102544,0
10312,4697309,638824,95,0,High Volume,Growth,683,638824,0
10313,1850611,442753,90,1,High Volume,Declining,541,370122,72631
10314,1787380,563584,88,0,Low Volume,Declining,495,357476,206108
10315,579995,186595,97,0,Low Volume,Growth,611,173998,12597
10316,1578789,286375,94,0,High Volume,Declining,590,286375,0
10317,892863,414535,88,1,Unstable,Declining,398,178572,235963
10318,1368077,631771,92,0,High Volume,Stable,625,410423,221348
10319,823609,186490,96,0,High Volume,Growth,689,186490,0
10320,1384533,339808,85,0,High Volume,Growth,661,339808,0
10321,1432758,524567,90,2,High Volume,Declining,470,286551,238016
10322,2142329,746276,96,1,Stable,Growth,590,428465,317811
10323,544814,120967,96,0,High Volume,Stable,650,120967,0
10324,623800,147473,95,0,Stable,Growth,653,147473,0
10325,2648573,547242,90,0,High Volume,Growth,655,547242,0
10326,1047639,163351,83,1,High Volume,Growth,601,163351,0
10327,4683817,1199817,91,1,Low Volume,Declining,446,936763,263054
10328,2374306,852127,92,0,High Volume,Growth,663,712291,139836
10329,3221668,1236750,93,0,Low Volume,Stable,531,644333,592417
10330,6129072,2454651,96,0,Stable,Stable,604,1838721,615930
10331,1547624,338356,80,0,Unstable,Declining,421,309524,28832
10332,1252198,493474,93,0,Unstable,Stable,506,250439,243035
10333,3982268,210791,94,0,Low Volume,Declining,510,210791,0
10334,2980527,788863,90,1,Low Volume,Stable,499,596105,192758
10335,1706808,695109,97,0,Low Volume,Stable,563,341361,353748
10336,6035483,2012955,98,0,Stable,Declining,527,1207096,805859
10337,1673126,440582,92,1,Low Volume,Growth,560,334625,105957
10338,2035433,692228,97,0,Stable,Growth,652,610629,81599
10339,2016710,923907,95,0,Low Volume,Stable,559,403342,520565
10340,938769,286204,91,0,Unstable,Growth,547,187753,98451
10341,2109725,864784,93,0,Low Volume,Declining,488,421945,442839
10342,6061138,2978045,92,0,Unstable,Stable,526,1212227,1765818
10343,2830530,1040236,92,0,Stable,Stable,559,566106,474130
10344,2032650,626049,95,0,Unstable,Declining,461,406530,219519
10345,1742073,116490,90,1,High Volume,Declining,543,116490,0
10346,2583598,564555,83,0,High Volume,Growth,669,564555,0
10347,3612148,1099716,96,1,High Volume,Growth,648,1083644,16072
10348,3228057,1319446,90,1,High Volume,Stable,578,645611,673835
10349,1520437,375772,88,0,Low Volume,Stable,520,304087,71685
10350,2571051,1239314,93,0,Stable,Growth,642,771315,467999
10351,2910839,501558,95,0,High Volume,Growth,697,501558,0
10352,885798,341081,94,0,Low Volume,Growth,602,265739,75342
10353,2268398,541158,81,1,High Volume,Declining,520,453679,87479
10354,500000,134347,86,0,High Volume,Growth,654,134347,0
10355,2916885,1199207,87,1,Stable,Growth,567,583377,615830
10356,3362766,616384,99,1,High Volume,Stable,601,616384,0
10357,3605738,337372,92,0,High Volume,Growth,663,337372,0
10358,1445495,410687,94,0,Low Volume,Growth,618,410687,0
10359,2538890,731093,87,0,Stable,Growth,609,731093,0
10360,6194442,2531826,95,1,High Volume,Growth,653,1858332,673494
10361,6144179,2984496,92,0,Stable,Declining,543,1228835,1755661
10362,1937021,145054,87,0,Stable,Growth,623,145054,0
10363,2216535,701002,92,0,High Volume,Growth,683,664960,36042
10364,4822143,1719457,77,0,High Volume,Declining,550,964428,755029
10365,596813,294593,94,2,Low Volume,Growth,534,119362,175231
10366,1531165,726026,86,1,High Volume,Growth,604,459349,266677
10367,5771580,2138964,94,0,Unstable,Stable,536,1154316,984648
10368,4326028,1232075,91,0,High Volume,Declining,560,865205,366870
10369,2664191,326858,92,0,Stable,Stable,562,326858,0
10370,594416,132483,88,1,High Volume,Growth,624,132483,0
10371,1905151,596893,94,0,Stable,Growth,636,571545,25348
10372,1236837,465471,98,0,High Volume,Declining,576,247367,218104
10373,2583953,868027,85,0,High Volume,Growth,666,775185,92842
10374,1037706,385358,86,1,Low Volume,Stable,478,207541,177817
10375,872765,212185,89,0,Stable,Growth,617,212185,0
10376,500000,188716,93,0,High Volume,Growth,690,150000,38716
10377,5269488,604324,99,0,Unstable,Declining,468,604324,0
10378,1440043,177361,94,0,High Volume,Stable,634,177361,0
10379,2248371,277167,92,0,Stable,Growth,615,277167,0
10380,1979212,892405,92,1,High Volume,Stable,579,395842,496563
10381,844122,71088,92,0,Unstable,Growth,554,71088,0
10382,724146,297391,94,0,Stable,Declining,530,144829,152562
10383,887131,137600,88,1,Low Volume,Growth,526,137600,0
10384,1111772,289943,83,0,High Volume,Growth,660,289943,0
10385,2658533,1228722,91,0,Stable,Stable,575,531706,697016
10386,1049082,329067,95,1,Stable,Stable,543,209816,119251
10387,8017943,1159017,85,0,High Volume,Stable,596,1159017,0
10388,4509608,801991,99,0,Stable,Growth,649,801991,0
10389,3785497,1757231,94,0,Unstable,Stable,515,757099,1000132
10390,1801757,436412,97,0,Unstable,Growth,596,360351,76061
10391,6658632,2091766,91,2,Stable,Growth,525,1331726,760040
10392,1665433,427965,98,0,Stable,Declining,533,333086,94879
10393,1933787,426008,95,1,High Volume,Growth,646,426008,0
10394,2271565,341815,93,0,Unstable,Growth,552,341815,0
10395,3476228,1247223,89,0,Stable,Stable,561,695245,551978
10396,3300308,1231704,94,0,High Volume,Stable,646,990092,241612
10397,1355797,235500,86,1,Low Volume,Growth,522,235500,0
10398,1294461,524328,93,0,Stable,Stable,586,258892,265436
10399,3308225,1437559,95,0,Stable,Growth,654,992467,445092
10400,3513732,1631439,94,0,Low Volume,Declining,508,702746,928693
10401,1447457,177379,94,1,Stable,Growth,586,177379,0
10402,556960,104021,96,0,Stable,Growth,647,104021,0
10403,1679736,734312,96,0,High Volume,Growth,675,503920,230392
10404,3265164,454978,98,0,High Volume,Declining,593,454978,0
10405,8404968,433367,84,0,High Volume,Declining,544,433367,0
10406,760426,336011,95,0,Stable,Growth,620,228127,107884
10407,1409496,277533,87,1,High Volume,Declining,501,277533,0
10408,1452036,343441,92,1,Low Volume,Declining,453,290407,53034
10409,5865770,1471430,90,1,Low Volume,Stable,485,1173154,298276
10410,1928102,832407,91,0,Low Volume,Stable,558,385620,446787
10411,959472,193863,94,1,High Volume,Growth,647,193863,0
10412,3100135,1399791,86,0,Stable,Growth,621,930040,469751
10413,1434446,469957,91,0,Stable,Growth,638,430333,39624
10414,744516,213884,81,0,Stable,Stable,539,148903,64981
10415,970708,190770,96,0,High Volume,Stable,642,190770,0
10416,7938489,1267541,94,1,Low Volume,Declining,469,1267541,0
10417,2696236,891986,91,0,Stable,Growth,617,808870,83116
10418,2161273,542701,90,0,High Volume,Stable,603,542701,0
10419,1623484,746368,81,0,Stable,Growth,599,324696,421672
10420,2504799,679395,98,0,Stable,Declining,556,500959,178436
10421,2481041,695455,93,0,Low Volume,Declining,498,496208,199247
10422,2504839,594963,97,0,High Volume,Growth,691,594963,0
10423,2173558,880657,96,0,High Volume,Stable,657,652067,228590
10424,3973026,958205,79,0,Low Volume,Growth,577,794605,163600
10425,2019748,345789,96,0,Stable,Growth,627,345789,0
10426,906774,397089,88,1,Low Volume,Stable,505,181354,215735
10427,1214766,386991,93,0,Stable,Growth,647,364429,22562
10428,500000,158090,94,0,Stable,Growth,648,150000,8090
10429,10033637,3259628,99,0,Stable,Growth,652,3010091,249537
10430,3953863,1476680,88,1,Stable,Growth,575,790772,685908
10431,1020643,194821,82,0,Stable,Stable,565,194821,0
10432,1582512,103227,91,0,Stable,Growth,615,103227,0
10433,1191232,494084,95,1,High Volume,Declining,556,238246,255838
10434,6810920,735629,83,0,High Volume,Declining,537,735629,0
10435,636728,238658,94,0,High Volume,Growth,698,191018,47640
10436,2172917,189135,96,1,High Volume,Stable,616,189135,0
10437,1817873,397912,90,2,Stable,Declining,435,363574,34338
10438,3841874,301056,95,0,Low Volume,Stable,568,301056,0
10439,1824456,519963,97,1,Stable,Growth,590,364891,155072
10440,500000,171956,86,1,Stable,Growth,571,100000,71956
10441,1621895,206216,92,1,High Volume,Growth,625,206216,0
10442,910975,197893,90,0,Unstable,Growth,565,182195,15698
10443,2113094,990212,87,0,Low Volume,Declining,494,422618,567594
10444,6245312,1555552,89,0,Stable,Growth,633,1555552,0
10445,500000,205572,88,0,High Volume,Growth,647,150000,55572
10446,1045308,488403,96,0,Low Volume,Stable,566,209061,279342
10447,1274221,622400,85,0,High Volume,Stable,606,382266,240134
10448,1461093,663694,94,0,Stable,Stable,586,292218,371476
10449,3584396,691188,81,1,Stable,Growth,543,691188,0
10450,1725736,833803,86,0,Low Volume,Growth,577,345147,488656
10451,2765252,1149178,91,0,Stable,Growth,626,829575,319603
10452,1201861,512869,99,0,High Volume,Growth,707,480744,32125
10453,2383164,135430,88,1,High Volume,Growth,628,135430,0
10454,3694065,1770962,82,0,High Volume,Stable,580,738813,1032149
10455,1103680,441627,95,0,Stable,Growth,645,331104,110523
10456,3704602,1465486,92,1,Low Volume,Declining,458,740920,724566
10457,2067598,179232,96,1,High Volume,Stable,594,179232,0
10458,4576148,707728,92,2,High Volume,Growth,577,707728,0
10459,1687678,815178,90,0,Stable,Growth,601,506303,308875
10460,2689849,740528,94,0,High Volume,Growth,688,740528,0
10461,1919384,439608,97,0,Low Volume,Growth,612,439608,0
10462,1835872,785704,90,0,High Volume,Growth,666,550761,234943
10463,2439111,217820,87,0,Low Volume,Declining,493,217820,0
10464,3046323,723879,96,0,High Volume,Stable,622,723879,0
10465,729670,159845,86,0,Stable,Growth,600,159845,0
10466,6242597,1294921,96,0,Stable,Stable,584,1248519,46402
10467,500000,94231,90,0,High Volume,Declining,569,94231,0
10468,1146415,165696,89,0,High Volume,Stable,616,165696,0
10469,1838728,235008,86,0,Unstable,Stable,505,235008,0
10470,2757637,932585,87,1,Stable,Growth,562,551527,381058
10471,6996622,3244527,95,0,High Volume,Growth,684,2098986,1145541
10472,500000,139492,97,0,High Volume,Growth,677,139492,0
10473,1320927,243168,85,0,Stable,Stable,539,243168,0
10474,500000,60811,98,0,Stable,Growth,652,60811,0
10475,2033558,861343,93,1,High Volume,Stable,593,406711,454632
10476,2464124,1200451,99,0,Stable,Growth,637,739237,461214
10477,7078953,1466192,89,0,High Volume,Stable,637,1466192,0
10478,2183649,395083,84,0,Stable,Growth,592,395083,0
10479,4570897,1465758,94,2,Low Volume,Declining,433,914179,551579
10480,3163121,1261763,96,0,Stable,Stable,605,948936,312827
10481,1399746,356839,92,0,Stable,Stable,573,279949,76890
10482,642313,214233,86,1,Low Volume,Growth,532,128462,85771
10483,2470675,920196,88,0,Stable,Growth,610,741202,178994
10484,600981,289833,89,0,High Volume,Stable,620,180294,109539
10485,5588188,694426,92,0,High Volume,Growth,674,694426,0
10486,1741662,868780,97,0,Low Volume,Declining,527,348332,520448
10487,5158425,1168231,84,1,Low Volume,Stable,466,1031685,136546
10488,1350288,506952,88,1,Low Volume,Growth,562,270057,236895
10489,2458546,756215,91,0,Stable,Stable,556,491709,264506
10490,2344257,630607,88,0,Stable,Declining,494,468851,161756
10491,1912582,696436,96,1,Stable,Declining,507,382516,313920
10492,1402648,319929,85,0,Stable,Growth,601,319929,0
10493,2714083,289727,89,1,Stable,Growth,592,289727,0
10494,945122,255185,85,0,Stable,Stable,564,189024,66161
10495,753475,214637,93,0,High Volume,Declining,576,150695,63942
10496,5358858,754827,87,0,Stable,Stable,576,754827,0
10497,3547432,1670942,97,0,Stable,Stable,571,709486,961456
10498,2090081,318453,85,1,High Volume,Stable,549,318453,0
10499,7512763,1759132,82,0,High Volume,Stable,593,1502552,256580
10500,1600437,191602,95,1,Low Volume,Stable,523,191602,0
10501,5712473,1662949,92,0,Stable,Declining,522,1142494,520455
10502,2281764,429969,92,0,Unstable,Stable,516,429969,0
10503,873444,235981,91,0,Stable,Growth,604,235981,0
10504,8696508,1313848,94,0,Stable,Declining,547,1313848,0
10505,4380041,324994,95,0,Stable,Declining,534,324994,0
10506,1799795,721091,94,1,Stable,Stable,540,359959,361132
10507,3547441,1200769,95,1,Low Volume,Growth,562,709488,491281
10508,1435519,291888,91,0,High Volume,Stable,615,291888,0
10509,3848982,274711,88,0,Stable,Growth,604,274711,0
10510,500000,219754,91,1,High Volume,Growth,645,150000,69754
10511,876909,110848,82,0,Stable,Growth,603,110848,0
10512,4340099,2034786,93,1,Unstable,Growth,529,868019,1166767
10513,1623793,430903,90,0,High Volume,Stable,629,430903,0
10514,2340871,475604,90,1,High Volume,Growth,641,475604,0
10515,675070,259086,82,1,Low Volume,Growth,528,135014,124072
10516,8695303,3865738,92,0,High Volume,Stable,630,2608590,1257148
10517,5139281,1114305,97,0,Low Volume,Growth,622,1114305,0
10518,1688670,393975,88,1,Stable,Growth,590,337734,56241
10519,1434380,351310,93,0,High Volume,Growth,699,351310,0
10520,4518468,2101293,91,0,Stable,Stable,583,903693,1197600
10521,9683911,3502223,96,0,Stable,Growth,630,2905173,597050
10522,4252460,686520,86,0,High Volume,Declining,543,686520,0
10523,11267603,1501407,88,0,Low Volume,Growth,564,1501407,0
10524,948009,145676,90,1,High Volume,Stable,567,145676,0
10525,1029404,173561,91,1,High Volume,Growth,635,173561,0
10526,765931,117634,90,0,Stable,Stable,554,117634,0
10527,2823276,977779,93,0,Low Volume,Growth,607,846982,130797
10528,2281818,233134,91,1,High Volume,Stable,584,233134,0
10529,1755807,393847,92,0,Low Volume,Growth,580,351161,42686
10530,3788220,1254939,84,1,Low Volume,Growth,528,757644,497295
10531,5314040,961241,78,0,High Volume,Growth,631,961241,0
10532,585060,46438,88,0,Stable,Growth,632,46438,0
10533,1229874,106779,91,1,Unstable,Growth,503,106779,0
10534,3821352,407681,96,0,High Volume,Growth,698,407681,0
10535,1363832,581169,91,0,High Volume,Growth,676,409149,172020
10536,1046995,362301,89,0,Low Volume,Stable,532,209399,152902
10537,4478640,353970,92,0,Stable,Stable,560,353970,0
10538,706727,159707,97,1,High Volume,Growth,662,159707,0
10539,1557724,273168,96,0,High Volume,Declining,593,273168,0
10540,2579008,799797,92,2,Low Volume,Growth,530,515801,283996
10541,1252866,357396,89,1,Stable,Stable,547,250573,106823
10542,3709934,988719,97,1,High Volume,Growth,654,988719,0
10543,1257830,240913,86,0,Unstable,Growth,542,240913,0
10544,6118916,685379,96,0,Stable,Declining,540,685379,0
10545,1793004,688638,95,0,Stable,Declining,525,358600,330038
10546,3392291,1512743,94,0,Low Volume,Declining,511,678458,834285
10547,3601349,1710165,98,0,Stable,Declining,553,720269,989896
10548,1200163,91667,84,1,High Volume,Growth,597,91667,0
10549,500000,191479,75,0,Low Volume,Growth,529,100000,91479
10550,2646119,997393,89,1,High Volume,Growth,620,793835,203558
10551,2100804,1000401,97,1,Unstable,Growth,550,420160,580241
10552,3093027,506674,88,2,Stable,Stable,467,506674,0
10553,1654117,635149,90,1,Stable,Stable,515,330823,304326
10554,1405155,104799,87,0,Unstable,Stable,519,104799,0
10555,9887466,3303013,85,0,High Volume,Stable,602,2966239,336774
10556,610551,126922,86,0,Stable,Growth,626,126922,0
10557,3566732,1412459,89,1,Low Volume,Growth,551,713346,699113
10558,1252082,549022,98,0,Stable,Stable,590,250416,298606
10559,1515684,324613,92,0,Stable,Declining,538,303136,21477
10560,1538499,440801,97,0,High Volume,Growth,708,440801,0
10561,1042625,107215,98,0,Stable,Growth,635,107215,0
10562,3131364,744038,95,0,Stable,Declining,531,626272,117766
10563,6031552,1280861,93,0,High Volume,Declining,583,1206310,74551
10564,2887816,382363,96,0,Stable,Stable,604,382363,0
10565,2153717,974590,89,1,High Volume,Growth,623,646115,328475
10566,900628,105049,91,0,Stable,Stable,579,105049,0
10567,2998013,1007580,90,0,Low Volume,Growth,600,899403,108177
10568,11129165,5014403,87,0,Stable,Declining,504,2225833,2788570
10569,1462188,673171,98,0,High Volume,Growth,709,584875,88296
10570,1467709,597296,92,1,Low Volume,Growth,557,293541,303755
10571,1265691,163608,96,1,Low Volume,Growth,552,163608,0
10572,1340387,560073,93,0,Low Volume,Stable,568,268077,291996
10573,500000,87227,95,2,Low Volume,Stable,460,87227,0
10574,2741534,1275030,91,0,Low Volume,Stable,562,548306,726724
10575,1008080,372071,88,0,Low Volume,Growth,568,201616,170455
10576,546773,220552,97,0,High Volume,Growth,694,164031,56521
10577,3622054,319699,90,0,High Volume,Declining,571,319699,0
10578,834331,260515,91,0,High Volume,Growth,666,250299,10216
10579,1512183,634382,95,0,Stable,Declining,539,302436,331946
10580,6408616,2805152,93,0,High Volume,Growth,678,1922584,882568
10581,642182,40383,94,0,Low Volume,Growth,582,40383,0
10582,581823,274982,82,0,Stable,Stable,560,116364,158618
10583,2459442,170937,85,0,Low Volume,Declining,491,170937,0
10584,4973279,1623942,94,0,High Volume,Declining,589,994655,629287
10585,562714,203716,91,0,Stable,Stable,581,112542,91174
10586,2747362,270080,84,0,Stable,Stable,571,270080,0
10587,3155948,225983,98,0,Stable,Stable,581,225983,0
10588,500000,201605,94,0,Low Volume,Stable,549,100000,101605
10589,3755759,837917,98,0,Unstable,Stable,544,751151,86766
10590,3997920,392598,85,0,High Volume,Growth,655,392598,0
10591,1545057,607517,92,0,Stable,Declining,511,309011,298506
10592,5399825,2333391,99,0,High Volume,Declining,585,1079965,1253426
10593,4921700,1547007,95,0,High Volume,Declining,594,984340,562667
10594,2153262,263896,93,0,Low Volume,Growth,596,263896,0
10595,1381726,78551,98,1,Unstable,Growth,553,78551,0
10596,910490,332658,94,0,Stable,Growth,631,273147,59511
10597,1924062,572529,98,0,Stable,Stable,583,384812,187717
10598,3127696,1072358,89,1,High Volume,Growth,619,938308,134050
10599,1529817,636302,82,0,Low Volume,Growth,586,305963,330339
10600,500000,122701,92,1,Unstable,Growth,507,100000,22701
10601,5470995,580100,95,0,Low Volume,Growth,589,580100,0
10602,2308662,1091980,83,0,Stable,Growth,611,692598,399382
10603,1463440,432253,95,0,Stable,Growth,615,432253,0
10604,3936201,1286675,93,1,Low Volume,Growth,575,787240,499435
10605,6714036,3155833,84,1,Unstable,Growth,493,1342807,1813026
10606,500000,234606,92,0,Unstable,Growth,586,100000,134606
10607,2806394,862805,87,0,Stable,Growth,618,841918,20887
10608,633288,116478,95,1,High Volume,Stable,592,116478,0
10609,2955825,1474073,82,1,Stable,Growth,571,591165,882908
10610,2196425,782735,91,0,High Volume,Declining,582,439285,343450
10611,3297190,770871,84,1,High Volume,Stable,579,659438,111433
10612,1329884,401527,99,0,High Volume,Declining,597,265976,135551
10613,500000,118563,90,0,Low Volume,Growth,608,118563,0
10614,1382917,621949,92,0,Low Volume,Growth,582,276583,345366
10615,2745512,733394,92,0,High Volume,Growth,660,733394,0
10616,4467385,1878927,96,0,High Volume,Stable,652,1340215,538712
10617,776487,332398,94,0,Unstable,Declining,466,155297,177101
10618,4509281,1898180,93,0,High Volume,Growth,667,1352784,545396
10619,1180799,442782,95,1,Stable,Declining,492,236159,206623
10620,2649708,1151815,91,0,High Volume,Stable,614,794912,356903
10621,1318605,295702,79,0,High Volume,Stable,593,263721,31981
10622,2293837,233050,92,0,Stable,Stable,569,233050,0
10623,4047063,1736613,82,0,Stable,Growth,588,809412,927201
10624,742954,203700,99,1,Stable,Stable,566,148590,55110
10625,1150924,123516,91,0,High Volume,Growth,688,123516,0
10626,2298966,234243,95,1,High Volume,Declining,565,234243,0
10627,13541464,1647442,92,0,Stable,Growth,614,1647442,0
10628,993956,385593,82,1,High Volume,Stable,569,198791,186802
10629,10141101,3751046,76,1,Unstable,Stable,419,2028220,1722826
10630,9855484,1396703,81,0,High Volume,Stable,597,1396703,0
10631,1834259,790778,97,2,Stable,Growth,562,366851,423927
10632,1562001,275822,92,0,High Volume,Growth,660,275822,0
10633,1139782,463713,88,1,Stable,Growth,568,227956,235757
10634,1877474,506848,90,0,Stable,Growth,617,506848,0
10635,643466,244000,96,0,High Volume,Stable,630,193039,50961
10636,1865442,413428,84,0,Stable,Growth,596,373088,40340
10637,6566583,1354117,99,1,Unstable,Stable,501,1313316,40801
10638,1216066,521220,95,0,Low Volume,Stable,568,243213,278007
10639,1635437,107752,94,0,Low Volume,Growth,583,107752,0
10640,508432,248436,96,0,High Volume,Growth,688,152529,95907
10641,2674438,913804,88,0,Low Volume,Growth,586,534887,378917
10642,2449968,599305,93,0,Low Volume,Growth,595,489993,109312
10643,2086423,693995,96,0,High Volume,Growth,671,625926,68069
10644,1667004,175425,86,0,High Volume,Growth,678,175425,0
10645,1568756,441328,87,0,Stable,Growth,591,313751,127577
10646,2962429,1461345,90,0,Stable,Stable,556,592485,868860
10647,1937573,302012,86,0,High Volume,Declining,568,302012,0
10648,2550953,956672,85,0,High Volume,Growth,669,765285,191387
10649,2354847,578673,99,0,Stable,Growth,647,578673,0
10650,4870669,1673592,88,0,Low Volume,Declining,475,974133,699459
10651,3407861,484595,88,0,Unstable,Stable,488,484595,0
10652,2313540,605475,93,0,Stable,Growth,611,605475,0
10653,6680729,3280517,94,0,Low Volume,Growth,593,1336145,1944372
10654,2775149,382635,95,0,Low Volume,Growth,594,382635,0
10655,5631972,1894597,91,0,Stable,Stable,582,1126394,768203
10656,3222133,995700,89,0,Unstable,Stable,503,644426,351274
10657,500000,152137,98,0,High Volume,Declining,592,100000,52137
10658,5631395,1840371,88,0,Unstable,Growth,551,1126279,714092
10659,2209200,609755,97,0,Low Volume,Declining,516,441840,167915
10660,1902037,109593,88,2,High Volume,Declining,491,109593,0
10661,2483250,1129987,93,0,Stable,Stable,590,496650,633337
10662,1504564,635137,89,1,Stable,Growth,595,300912,334225
10663,2377650,305232,95,0,Stable,Growth,634,305232,0
10664,1234898,291402,99,1,Low Volume,Growth,577,246979,44423
10665,5495377,2180275,84,0,Low Volume,Growth,567,1099075,1081200
10666,1810529,889021,95,1,High Volume,Stable,586,362105,526916
10667,1459979,697887,98,0,Unstable,Stable,514,291995,405892
10668,946058,430184,92,1,High Volume,Stable,597,189211,240973
10669,2458398,298126,95,0,Stable,Stable,578,298126,0
10670,2302914,1062827,93,0,Stable,Growth,622,690874,371953
10671,2705344,1204690,90,0,High Volume,Stable,618,811603,393087
10672,871698,191449,92,1,Stable,Stable,516,174339,17110
10673,550760,125317,95,3,Unstable,Declining,359,110152,15165
10674,3270564,840401,83,1,Stable,Growth,551,654112,186289
10675,6502605,2245213,95,0,Stable,Growth,618,1950781,294432
10676,872325,146006,95,0,Stable,Growth,634,146006,0
10677,7071287,426588,97,0,Low Volume,Stable,544,426588,0
10678,2488346,282560,84,0,Unstable,Stable,512,282560,0
10679,1971588,489057,93,1,Stable,Growth,574,394317,94740
10680,1442605,255198,96,0,Low Volume,Declining,513,255198,0
10681,654997,258090,94,0,High Volume,Growth,688,196499,61591
10682,4369603,428267,94,0,Stable,Growth,633,428267,0
10683,1066097,493453,95,0,High Volume,Stable,643,319829,173624
10684,1062521,481213,93,0,High Volume,Stable,647,318756,162457
10685,4384302,2012134,82,1,Low Volume,Growth,545,876860,1135274
10686,500000,191412,95,1,Low Volume,Stable,496,100000,91412
10687,586027,57519,98,0,High Volume,Declining,609,57519,0
10688,1954202,483004,92,1,Low Volume,Growth,558,390840,92164
10689,2507076,273603,92,1,Stable,Growth,584,273603,0
10690,2922026,1444839,98,0,Low Volume,Growth,609,876607,568232
10691,1557451,311284,92,0,Stable,Stable,579,311284,0
10692,15011029,4704438,94,0,Stable,Stable,595,3002205,1702233
10693,1652312,662126,92,1,Stable,Declining,490,330462,331664
10694,1648491,765357,85,0,High Volume,Stable,595,329698,435659
10695,1048017,408723,92,1,Stable,Growth,570,209603,199120
10696,2189372,774001,96,0,High Volume,Declining,587,437874,336127
10697,3242869,842146,76,0,Stable,Growth,571,648573,193573
10698,5193209,1674447,94,0,High Volume,Stable,632,1557962,116485
10699,602337,55640,96,0,Stable,Growth,643,55640,0
10700,1628555,729210,92,1,Unstable,Declining,443,325711,403499
10701,2834463,835316,86,0,Low Volume,Stable,522,566892,268424
10702,3171281,215840,97,1,High Volume,Growth,651,215840,0
10703,1993174,924745,89,0,Stable,Stable,562,398634,526111
10704,3060042,826780,99,0,Low Volume,Declining,507,612008,214772
10705,1038023,457628,98,0,Low Volume,Growth,607,311406,146222
10706,6895119,3003511,96,0,High Volume,Stable,638,2068535,934976
10707,4386764,1829668,86,0,Stable,Growth,603,1316029,513639
10708,676074,52485,97,1,High Volume,Declining,532,52485,0
10709,838959,135223,89,0,Low Volume,Declining,468,135223,0
10710,858089,380989,84,1,Stable,Growth,569,171617,209372
10711,3410522,1550239,97,0,High Volume,Stable,625,1023156,527083
10712,709430,181707,96,0,Stable,Stable,575,141886,39821
10713,1521459,377350,83,0,Low Volume,Declining,457,304291,73059
10714,2852663,367461,80,0,High Volume,Stable,586,367461,0
10715,1880536,913536,89,0,Stable,Growth,615,564160,349376
10716,2439028,355884,96,0,Stable,Stable,593,355884,0
10717,845225,114884,95,1,Unstable,Growth,545,114884,0
10718,3191123,1108366,88,0,High Volume,Growth,677,957336,151030
10719,1213999,193366,85,0,Low Volume,Stable,533,193366,0
10720,1529275,722502,96,3,High Volume,Stable,507,305855,416647
10721,2398095,131675,89,0,Unstable,Growth,576,131675,0
10722,2153193,113234,99,1,Stable,Stable,547,113234,0
10723,2021164,560256,93,0,High Volume,Growth,691,560256,0
10724,1087616,293252,93,1,Stable,Growth,599,217523,75729
10725,1560256,192713,97,0,High Volume,Growth,692,192713,0
10726,1986226,541314,95,0,High Volume,Declining,593,397245,144069
10727,659958,155253,91,0,Stable,Declining,543,131991,23262
10728,1369524,617174,95,0,Unstable,Growth,575,273904,343270
10729,2703733,146446,84,0,Stable,Stable,571,146446,0
10730,713581,349170,84,1,Stable,Declining,453,142716,206454
10731,5001585,1655408,91,1,Low Volume,Stable,498,1000317,655091
10732,5474933,647846,97,1,High Volume,Growth,656,647846,0
10733,732252,52021,89,0,Stable,Growth,626,52021,0
10734,5874290,1716159,89,0,Unstable,Growth,559,1174858,541301
10735,1767603,275217,93,0,High Volume,Growth,691,275217,0
10736,2771257,514136,86,0,Stable,Declining,511,514136,0
10737,1332649,213636,88,0,Low Volume,Growth,569,213636,0
10738,4149240,1421436,99,0,High Volume,Stable,660,1244772,176664
10739,2743857,820655,97,1,Unstable,Growth,539,548771,271884
10740,1033723,87958,95,0,Stable,Stable,587,87958,0
10741,780616,223988,96,0,Unstable,Growth,582,156123,67865
10742,616466,250307,91,0,Stable,Declining,531,123293,127014
10743,2304452,199422,98,0,Stable,Growth,639,199422,0
10744,3134490,1411720,98,0,Low Volume,Growth,595,626898,784822
10745,3337633,1035461,87,0,Unstable,Declining,459,667526,367935
10746,1804177,862002,97,0,Stable,Growth,653,541253,320749
10747,785757,91669,84,0,Low Volume,Growth,569,91669,0
10748,1148928,571137,96,0,Stable,Declining,526,229785,341352
10749,4984676,1694405,90,0,Stable,Stable,551,996935,697470
10750,1345528,410887,81,0,High Volume,Stable,577,269105,141782
10751,2223814,626839,96,0,Stable,Growth,637,626839,0
10752,838592,50856,89,0,Low Volume,Growth,570,50856,0
10753,2595440,1227222,90,0,High Volume,Stable,604,778632,448590
10754,1374846,467169,95,0,Stable,Stable,581,274969,192200
10755,4580736,417909,86,1,Stable,Growth,552,417909,0
10756,3681556,218789,93,0,Stable,Growth,616,218789,0
10757,1333657,97160,85,0,Unstable,Stable,506,97160,0
10758,1791688,580916,91,0,Low Volume,Stable,547,358337,222579
10759,1275829,416312,92,1,Stable,Stable,540,255165,161147
10760,636954,175067,96,0,Low Volume,Growth,612,175067,0
10761,998537,187770,86,0,Low Volume,Growth,588,187770,0
10762,2323474,672144,93,0,Low Volume,Growth,606,672144,0
10763,2572034,726177,87,0,Low Volume,Stable,525,514406,211771
10764,2232959,131157,95,1,Low Volume,Growth,571,131157,0
10765,1557533,275856,91,1,High Volume,Declining,551,275856,0
10766,4182640,309237,95,1,High Volume,Growth,638,309237,0
10767,2086156,949346,96,0,Unstable,Stable,520,417231,532115
10768,3480210,1309779,86,0,High Volume,Declining,569,696042,613737
10769,500000,249126,88,0,High Volume,Stable,628,150000,99126
10770,500000,92989,96,1,High Volume,Growth,641,92989,0
10771,2488101,1107998,95,0,Low Volume,Growth,620,746430,361568
10772,634243,203829,90,0,High Volume,Stable,638,190272,13557
10773,1672849,424747,86,0,Stable,Stable,542,334569,90178
10774,1557079,233808,93,0,Stable,Growth,616,233808,0
10775,7059752,2698777,98,0,High Volume,Growth,683,2117925,580852
10776,2730505,1247468,74,0,High Volume,Growth,603,819151,428317
10777,2264098,352947,90,1,High Volume,Stable,590,352947,0
10778,3873205,499355,82,0,High Volume,Declining,564,499355,0
10779,2662559,967307,95,0,Stable,Stable,589,532511,434796
10780,1374854,673181,92,0,High Volume,Growth,689,412456,260725
10781,4672388,1810456,94,0,Stable,Stable,576,934477,875979
10782,816025,145302,93,0,Unstable,Growth,565,145302,0
10783,2567897,613676,94,0,Low Volume,Growth,603,613676,0
10784,574896,128169,88,0,Low Volume,Declining,496,114979,13190
10785,2334142,1011717,94,1,Unstable,Growth,517,466828,544889
10786,2313777,918840,83,0,Stable,Declining,496,462755,456085
10787,7581063,2388330,90,0,Low Volume,Stable,549,1516212,872118
10788,566947,98497,98,1,Low Volume,Stable,506,98497,0
10789,1226028,578801,91,0,Unstable,Growth,573,245205,333596
10790,3829121,1317186,84,0,Stable,Declining,493,765824,551362
10791,2592813,1261960,98,1,High Volume,Growth,643,777843,484117
10792,2290416,712440,88,0,High Volume,Declining,579,458083,254357
10793,922730,387119,96,0,Stable,Stable,573,184546,202573
10794,1235944,514026,93,1,Low Volume,Growth,569,247188,266838
10795,5368359,1083324,93,1,Stable,Stable,554,1073671,9653
10796,1902716,920552,90,0,High Volume,Stable,632,570814,349738
10797,2677215,160295,81,0,Low Volume,Stable,502,160295,0
10798,1808212,715907,91,1,Unstable,Growth,540,361642,354265
10799,769527,372836,97,1,Low Volume,Growth,576,153905,218931
10800,4185130,847525,86,1,High Volume,Declining,513,837026,10499
10801,2965588,1013192,98,0,Stable,Stable,597,593117,420075
10802,12540945,3799912,97,0,Unstable,Growth,601,3762283,37629
10803,879875,345508,95,2,Stable,Growth,558,175975,169533
10804,3828786,1683824,85,0,Stable,Growth,593,765757,918067
10805,694373,223151,88,0,High Volume,Growth,668,208311,14840
10806,2248732,938074,98,0,Low Volume,Growth,616,674619,263455
10807,4330551,825093,90,0,Low Volume,Growth,572,825093,0
10808,500000,76432,80,0,Stable,Declining,501,76432,0
10809,1682942,410302,97,0,Stable,Stable,580,336588,73714
10810,1263545,448535,91,1,High Volume,Growth,647,379063,69472
10811,1130798,151822,88,1,Stable,Declining,475,151822,0
10812,2698402,961059,94,1,Low Volume,Stable,505,539680,421379
10813,4859998,1104882,82,0,High Volume,Growth,650,1104882,0
10814,1782232,727166,93,0,High Volume,Growth,673,534669,192497
10815,2337025,155590,98,0,Low Volume,Growth,623,155590,0
10816,2172626,761706,93,2,Stable,Stable,509,434525,327181
10817,1985622,679917,96,0,Unstable,Stable,521,397124,282793
10818,829456,392682,98,0,Stable,Growth,631,248836,143846
10819,4812637,1785562,89,0,High Volume,Growth,654,1443791,341771
10820,2510911,1025295,86,1,Stable,Growth,578,502182,523113
10821,2719355,1242925,93,1,High Volume,Growth,655,815806,427119
10822,1040063,367947,93,0,High Volume,Stable,645,312018,55929
10823,1373158,247950,93,1,Stable,Declining,471,247950,0
10824,1722165,760161,93,0,Stable,Growth,641,516649,243512
10825,581113,224548,97,2,High Volume,Declining,502,116222,108326
10826,513791,123822,96,1,Stable,Growth,609,123822,0
10827,1226165,453360,96,0,Low Volume,Declining,519,245233,208127
10828,3011704,1326535,94,1,Low Volume,Growth,562,602340,724195
10829,1175836,575035,97,0,Stable,Growth,630,352750,222285
10830,877608,419986,95,1,Stable,Growth,615,263282,156704
10831,1033283,202934,89,0,Stable,Declining,522,202934,0
10832,1377425,330254,87,0,High Volume,Growth,653,330254,0
10833,1493918,148333,91,0,Low Volume,Declining,481,148333,0
10834,11211125,1809419,84,0,Low Volume,Growth,584,1809419,0
10835,4609807,2060997,92,1,High Volume,Growth,646,1382942,678055
10836,4501041,955942,96,0,Stable,Declining,529,900208,55734
10837,5049826,1662649,92,0,High Volume,Growth,678,1514947,147702
10838,891752,311832,95,2,Unstable,Stable,449,178350,133482
10839,745722,299648,92,0,Low Volume,Declining,504,149144,150504
10840,817907,108176,96,0,High Volume,Growth,700,108176,0
10841,5766667,1079323,88,0,Unstable,Stable,501,1079323,0
10842,1279841,322202,86,0,High Volume,Growth,678,322202,0
10843,728625,156056,100,1,High Volume,Growth,651,156056,0
10844,1404516,691454,96,0,High Volume,Stable,653,421354,270100
10845,1638211,697425,97,0,Low Volume,Growth,594,327642,369783
10846,2457686,653398,95,0,Unstable,Growth,567,491537,161861
10847,2423591,1080124,90,0,High Volume,Growth,680,727077,353047
10848,1022188,211024,90,0,Unstable,Stable,511,204437,6587
10849,3431559,1385055,90,0,Stable,Declining,536,686311,698744
10850,1189026,179132,86,0,Stable,Growth,626,179132,0
10851,1749742,695601,90,0,Unstable,Growth,569,349948,345653
10852,3434628,877218,97,1,High Volume,Growth,664,877218,0
10853,1186529,116724,92,0,Stable,Stable,586,116724,0
10854,1257352,217482,93,0,Stable,Stable,564,217482,0
10855,3182999,735348,92,0,Stable,Growth,631,735348,0
10856,998304,386525,90,0,High Volume,Growth,662,299491,87034
10857,1457403,120735,86,0,Stable,Declining,516,120735,0
10858,3092820,1072578,95,0,High Volume,Declining,590,618564,454014
10859,10254980,3816967,92,1,Unstable,Growth,544,2050996,1765971
10860,3218171,1107902,87,1,Stable,Declining,472,643634,464268
10861,2893889,1135277,95,0,Unstable,Declining,458,578777,556500
10862,3031722,394657,83,0,Low Volume,Stable,533,394657,0
10863,840244,264002,99,1,High Volume,Stable,591,168048,95954
10864,2174866,1029832,83,0,Stable,Stable,556,434973,594859
10865,1936101,628948,87,1,Low Volume,Declining,441,387220,241728
10866,2564483,833717,91,0,Stable,Growth,611,769344,64373
10867,2176452,830094,90,0,Stable,Growth,609,652935,177159
10868,2686527,537149,86,1,Stable,Stable,537,537149,0
10869,1545451,564421,94,0,Low Volume,Growth,614,463635,100786
10870,2077939,960642,93,0,Stable,Growth,648,623381,337261
10871,742470,40764,98,0,Stable,Growth,628,40764,0
10872,1535051,677803,91,1,High Volume,Growth,621,460515,217288
10873,6032468,895087,89,1,Unstable,Declining,413,895087,0
10874,2558794,652916,94,0,Stable,Growth,644,652916,0
10875,1949850,845370,95,1,Low Volume,Stable,511,389970,455400
10876,9037549,3802643,91,0,Stable,Growth,608,2711264,1091379
10877,667525,301299,93,0,Stable,Stable,585,133505,167794
10878,816217,386224,90,0,Stable,Declining,526,163243,222981
10879,7804173,1960569,97,2,High Volume,Declining,504,1560834,399735
10880,2057020,710420,89,0,Stable,Stable,551,411404,299016
10881,1633007,368595,83,1,Unstable,Growth,495,326601,41994
10882,759668,157876,96,0,High Volume,Growth,671,157876,0
10883,2836714,692776,95,0,Stable,Growth,655,692776,0
10884,3065030,1178149,92,0,Unstable,Growth,552,613006,565143
10885,826045,227698,95,0,High Volume,Stable,651,227698,0
10886,1772284,737849,85,0,High Volume,Growth,648,531685,206164
10887,1516002,584189,93,0,Unstable,Declining,461,303200,280989
10888,2433355,144092,86,0,Low Volume,Growth,586,144092,0
10889,809846,270170,84,0,Stable,Growth,615,242953,27217
10890,5398102,1330400,97,0,Stable,Stable,604,1330400,0
10891,4125340,1053954,93,0,Unstable,Declining,486,825068,228886
10892,1482825,620218,95,0,High Volume,Growth,703,593130,27088
10893,1667548,494301,90,1,High Volume,Declining,534,333509,160792
10894,1777756,797377,95,1,Stable,Stable,559,355551,441826
10895,1063795,394415,79,0,High Volume,Growth,636,319138,75277
10896,1390615,415485,93,1,Stable,Stable,549,278123,137362
10897,1597234,622190,85,0,Stable,Growth,609,479170,143020
10898,7205064,484592,100,0,Unstable,Stable,548,484592,0
10899,4228233,262944,91,1,Stable,Growth,596,262944,0
10900,4187958,366476,97,0,Unstable,Growth,570,366476,0
10901,2665602,658149,92,1,Low Volume,Stable,504,533120,125029
10902,811093,126492,86,2,Low Volume,Stable,466,126492,0
10903,1918026,945429,95,0,Stable,Stable,575,383605,561824
10904,4309751,1267199,88,0,Stable,Declining,533,861950,405249
10905,724610,252227,85,0,High Volume,Growth,674,217383,34844
10906,3299372,578938,94,0,Stable,Growth,647,578938,0
10907,12712386,2476482,96,1,Low Volume,Declining,470,2476482,0
10908,4636421,931725,92,0,Low Volume,Stable,563,927284,4441
10909,6145455,2239595,99,0,Low Volume,Growth,621,1843636,395959
10910,2361178,621386,91,0,High Volume,Growth,673,621386,0
10911,4300946,1216986,89,0,High Volume,Stable,634,1216986,0
10912,1116509,353265,87,1,Stable,Growth,577,223301,129964
10913,3747843,1484016,81,1,Stable,Declining,434,749568,734448
10914,3346784,303441,92,0,High Volume,Growth,661,303441,0
10915,2500319,999111,94,0,Low Volume,Stable,566,500063,499048
10916,5681955,1724222,88,0,Stable,Declining,502,1136391,587831
10917,1288478,452376,97,0,Low Volume,Stable,560,257695,194681
10918,1707181,336995,87,0,Stable,Growth,623,336995,0
10919,2140114,501266,93,0,High Volume,Growth,687,501266,0
10920,870055,134010,98,0,High Volume,Stable,650,134010,0
10921,2377465,1166586,97,0,Low Volume,Declining,491,475493,691093
10922,501248,137167,93,0,Low Volume,Growth,591,100249,36918
10923,4581622,2282723,96,0,Stable,Growth,620,1374486,908237
10924,2058133,556527,93,1,High Volume,Growth,619,556527,0
10925,1307053,194605,95,0,High Volume,Stable,634,194605,0
10926,1017136,283123,94,1,Stable,Growth,611,283123,0
10927,1643497,111459,92,0,High Volume,Stable,631,111459,0
10928,3438713,1571995,76,2,High Volume,Stable,489,687742,884253
10929,3073081,1285616,87,0,Unstable,Growth,536,614616,671000
10930,1127563,424662,95,0,Low Volume,Stable,543,225512,199150
10931,1007687,326916,88,1,Low Volume,Growth,559,201537,125379
10932,3353513,1042692,93,0,Stable,Growth,628,1006053,36639
10933,1112502,554613,97,0,Stable,Growth,630,333750,220863
10934,2080103,364224,93,0,High Volume,Declining,568,364224,0
10935,2189106,877521,90,0,Stable,Stable,580,437821,439700
10936,2545022,793111,97,0,Low Volume,Declining,510,509004,284107
10937,3939705,1927092,88,0,High Volume,Growth,668,1181911,745181
10938,721891,305007,98,0,Stable,Growth,654,216567,88440
10939,500000,249668,93,1,Unstable,Growth,549,100000,149668
10940,1259269,396350,91,0,Low Volume,Stable,531,251853,144497
10941,8378863,1190174,93,1,Low Volume,Declining,479,1190174,0
10942,9996437,2765606,93,0,High Volume,Growth,682,2765606,0
10943,8579976,3174591,82,0,High Volume,Stable,579,1715995,1458596
10944,1699110,677031,96,0,Stable,Growth,654,509733,167298
10945,500000,25115,91,0,Stable,Declining,526,25115,0
10946,500000,138631,86,1,High Volume,Declining,511,100000,38631
10947,1213197,189083,96,0,High Volume,Declining,575,189083,0
10948,1692202,750847,92,0,Stable,Growth,632,507660,243187
10949,5612464,666803,96,0,High Volume,Growth,697,666803,0
10950,3969872,1389079,98,0,Stable,Growth,637,1190961,198118
10951,2378366,403675,93,0,Stable,Declining,548,403675,0
10952,972985,204759,97,1,High Volume,Growth,670,204759,0
10953,919308,435064,97,0,Stable,Declining,538,183861,251203
10954,2429758,384392,93,1,High Volume,Stable,581,384392,0
10955,3462983,321196,84,0,Stable,Stable,560,321196,0
10956,2712836,220223,96,0,Unstable,Growth,585,220223,0
10957,866590,240112,82,1,High Volume,Stable,539,173318,66794
10958,3336838,1130421,98,0,High Volume,Growth,700,1130421,0
10959,2787704,549964,92,1,High Volume,Stable,601,549964,0
10960,841942,303619,95,1,Stable,Growth,598,168388,135231
10961,1058690,82012,95,0,Low Volume,Declining,508,82012,0
10962,3439363,1498876,94,1,Unstable,Declining,414,687872,811004
10963,1643591,686126,93,0,Low Volume,Stable,547,328718,357408
10964,7069624,3488671,92,0,Stable,Stable,594,1413924,2074747
10965,2960603,1395709,90,0,Low Volume,Stable,528,592120,803589
10966,1343374,282496,98,2,High Volume,Stable,565,268674,13822
10967,1966637,451685,97,0,High Volume,Declining,592,393327,58358
10968,2085891,804495,90,0,Stable,Declining,515,417178,387317
10969,1107137,122158,94,0,High Volume,Stable,619,122158,0
10970,955442,182782,94,0,Low Volume,Growth,598,182782,0
10971,3475024,359121,86,0,High Volume,Growth,674,359121,0
10972,3898953,993059,95,0,High Volume,Growth,691,993059,0
10973,3213995,959062,89,0,High Volume,Stable,631,959062,0
10974,6664160,966451,91,0,Unstable,Declining,477,966451,0
10975,1285401,79675,94,0,Unstable,Stable,515,79675,0
10976,7567828,2828174,98,0,Unstable,Stable,554,1513565,1314609
10977,964402,56902,92,0,Unstable,Growth,567,56902,0
10978,881916,430403,97,0,Low Volume,Growth,612,264574,165829
10979,500000,74862,91,1,High Volume,Declining,523,74862,0
10980,1387985,484067,100,0,Stable,Growth,661,416395,67672
10981,1325131,325503,89,0,Stable,Stable,573,265026,60477
10982,3019947,232093,91,1,Low Volume,Stable,502,232093,0
10983,2409941,632568,95,0,Unstable,Growth,588,481988,150580
10984,763464,215711,91,1,Stable,Stable,531,152692,63019
10985,1448181,629390,98,0,Stable,Declining,533,289636,339754
10986,1473028,559098,91,0,High Volume,Growth,665,441908,117190
10987,500000,42843,97,0,High Volume,Growth,698,42843,0
10988,904595,130373,96,0,High Volume,Growth,675,130373,0
10989,1070192,203710,85,0,High Volume,Stable,606,203710,0
10990,6242554,639134,89,0,High Volume,Stable,624,639134,0
10991,2310930,590684,88,0,Low Volume,Growth,579,462186,128498
10992,3367681,1660062,84,0,Stable,Growth,598,673536,986526
10993,597848,168340,96,0,Stable,Growth,657,168340,0
10994,5154453,1978521,98,1,Stable,Stable,573,1030890,947631
10995,5614604,2006222,93,1,Low Volume,Declining,457,1122920,883302
10996,500000,216230,90,0,Stable,Stable,587,100000,116230
10997,1127763,165866,91,1,High Volume,Growth,630,165866,0
10998,2947926,1147397,98,0,High Volume,Stable,660,884377,263020
10999,3320118,1482797,96,0,High Volume,Stable,646,996035,486762
